namePlayer,idPlayer,Season,Minutes,gp,Assists,Fg3Ast,Arc3Ast,Corner3Ast,RimAst,Turnovers,BadPassTO,DeadBallTO,LiveBallTO,OffPoss,Usage,PassesMade,PotAst,SecAst,playcomp
Justin Anderson,1626147,2018-19,464,48,23,11,8,3,7,23,6,12,11,999,17.33333333,351,50,3,0.289855072
Kevin Huerter,1628989,2018-19,2049,75,214,96,63,33,92,109,55,40,69,4391,15.74332403,1433,394,21,0.801398749
Omari Spellman,1629016,2018-19,805,46,47,22,18,4,20,31,12,15,16,1734,15.06361323,1186,94,4,0.584268874
Isaac Humphries,1629353,2018-19,56,5,0,0,0,0,0,0,0,0,0,127,14.38356164,73,2,0,0
Jaylen Adams,1629121,2018-19,428,34,65,34,24,10,25,28,12,10,18,924,13.55769231,770,138,12,0.36007326
Trae Young,1629027,2018-19,2503,81,653,263,159,104,336,308,161,92,216,5400,28.41538963,4477,1239,63,1.121958995
Taurean Prince,1627752,2018-19,1552,55,118,47,22,25,52,100,39,40,60,3368,19.38963431,1058,226,8,0.66487886
Dewayne Dedmon,203473,2018-19,1609,64,90,34,27,7,41,84,26,42,42,3394,17.01686122,2232,155,7,0.499110904
Vince Carter,1713,2018-19,1330,76,87,35,27,8,39,48,22,19,29,2877,16.98877805,1828,154,7,0.515887041
Miles Plumlee,203101,2018-19,173,18,17,6,5,1,6,10,5,3,7,378,17.18377088,248,18,2,0.139215686
John Collins,1628381,2018-19,1828,61,121,46,28,18,54,120,28,65,55,3916,23.50332594,2902,178,14,0.499046358
Alex Poythress,1627816,2018-19,305,21,17,11,9,2,2,13,0,12,1,651,14.53804348,451,30,0,0.405731523
Kent Bazemore,203145,2018-19,1643,67,152,64,40,24,68,121,56,40,81,3546,22.04020849,1478,296,16,0.692376107
Alex Len,203458,2018-19,1544,77,86,33,29,4,34,97,20,67,30,3359,22.01882845,1986,158,5,0.524532155
DeAndre' Bembry,1627761,2018-19,1931,82,202,92,56,36,97,141,54,52,89,4148,17.34607219,1851,419,30,0.835258485
Jayson Tatum,1628369,2018-19,2455,79,168,76,56,20,61,122,28,68,54,5052,22.26742129,2225,332,27,0.619049573
Jonathan Gibson,1626780,2018-19,0,0,0,0,0,0,0,0,0,0,0,0,0,0,0,0,0
Jaylen Brown,1627759,2018-19,1913,74,100,43,35,8,36,99,22,55,44,3968,22.08726946,1292,198,20,0.565271645
Brad Wanamaker,202954,2018-19,343,36,56,17,11,6,21,19,10,7,12,723,16.68711656,549,106,7,0.134711779
Kyrie Irving,202681,2018-19,2214,67,464,165,126,39,167,172,80,54,118,4650,29.17551651,3437,761,65,0.718637532
Terry Rozier,1626179,2018-19,1791,79,231,107,86,21,77,68,32,20,48,3665,18.63099542,3184,444,44,0.615262779
Marcus Morris,202694,2018-19,2091,75,109,41,27,14,45,92,21,52,40,4318,20.92058885,2224,216,20,0.511152115
Gordon Hayward,202330,2018-19,1863,72,244,104,78,26,91,105,41,43,62,3887,18.8588451,2358,463,25,0.713898325
Daniel Theis,1628464,2018-19,908,66,68,30,23,7,19,33,6,23,10,1884,15.54211261,1114,115,7,0.516128381
RJ Hunter,1626154,2018-19,26,1,3,2,2,0,1,0,0,0,0,53,22.58064516,20,6,1,0
Guerschon Yabusele,1627824,2018-19,251,41,15,8,7,1,5,15,3,12,3,523,17.28813559,276,29,1,0.466666667
Marcus Smart,203935,2018-19,2200,80,321,121,101,20,126,123,63,43,80,4511,14.8111332,2893,551,41,0.660249179
Semi Ojeleye,1628400,2018-19,594,56,23,12,10,2,6,19,7,10,9,1224,14.10998553,551,42,4,0.438312742
Al Horford,201143,2018-19,1973,68,283,123,89,34,109,102,38,44,58,4054,19.27118265,2914,511,32,0.73126895
Robert Williams III,1629057,2018-19,283,32,7,1,0,1,4,10,1,7,3,584,10.3500761,292,21,3,0.280952381
Aron Baynes,203382,2018-19,821,51,57,30,29,1,7,40,8,25,15,1700,15.22419187,913,96,7,0.41286791
PJ Dozier,1628408,2018-19,51,6,5,1,0,1,3,0,0,0,0,110,17.46031746,63,10,2,0
Rodions Kurucs,1629066,2018-19,1294,63,52,19,16,3,28,77,19,44,33,2800,17.98925071,1130,108,5,0.606693032
D'Angelo Russell,1626156,2018-19,2448,81,563,196,146,50,311,253,114,82,171,5120,31.8236611,4224,1012,51,0.99488511
Jared Dudley,201162,2018-19,1220,59,83,37,28,9,36,43,23,17,26,2486,10.73326249,1807,137,11,0.532745703
Spencer Dinwiddie,203915,2018-19,1914,68,311,125,79,46,130,152,52,77,75,4005,24.91723681,2699,634,41,0.888273958
DeMarre Carroll,201960,2018-19,1703,67,85,35,25,10,37,73,17,35,38,3546,18.73305398,1604,155,13,0.527858779
Theo Pinson,1629033,2018-19,211,18,21,7,6,1,7,18,10,6,12,447,19.57773512,283,41,1,0.111111111
Joe Harris,203925,2018-19,2294,76,181,74,49,25,82,121,50,49,72,4817,17.05383481,2479,367,26,0.638224141
Shabazz Napier,203894,2018-19,983,56,143,51,39,12,73,66,24,30,36,2042,24.17204301,1402,286,14,0.846921729
Alan Williams,1626210,2018-19,26,5,3,2,1,1,1,1,1,0,1,58,22.53521127,46,6,0,0.333333333
Ed Davis,202334,2018-19,1446,81,61,34,31,3,14,64,9,43,21,2949,12.93078056,2140,102,7,0.462379883
Treveon Graham,1626203,2018-19,715,35,34,15,11,4,13,17,4,12,5,1520,12.62304574,760,59,5,0.552305924
Caris LeVert,1627747,2018-19,1063,40,156,80,67,13,54,69,30,25,44,2210,24.15033986,1234,301,23,0.840163709
Rondae Hollis-Jefferson,1626178,2018-19,1234,59,96,54,38,16,36,68,18,29,39,2602,21.51770658,1855,194,8,0.674784724
Dzanan Musa,1629058,2018-19,39,9,2,1,1,0,1,4,2,2,2,86,25,45,8,2,0.5
Jarrett Allen,1628386,2018-19,2096,80,110,63,52,11,31,103,26,57,46,4397,16.13098848,2564,190,6,0.537096626
Allen Crabbe,203459,2018-19,1133,43,46,15,10,5,21,46,10,33,13,2376,16.33184524,913,86,8,0.525172103
Miles Bridges,1628970,2018-19,1696,80,95,34,27,7,40,50,19,17,33,3481,15.14919663,1479,161,7,0.429400616
Malik Monk,1628370,2018-19,1258,73,117,26,21,5,70,86,41,33,53,2618,24.48489011,900,220,9,0.701078338
Marvin Williams,101107,2018-19,2133,75,92,40,28,12,35,47,12,25,22,4345,15.06318793,2020,150,9,0.470436603
Jeremy Lamb,203087,2018-19,2250,79,172,70,52,18,76,80,33,30,50,4583,22.56568779,2069,349,31,0.630962176
Devonte' Graham,1628984,2018-19,676,46,121,36,27,9,59,30,12,13,17,1380,17.13917526,1117,204,12,0.747308943
Nicolas Batum,201587,2018-19,2354,75,247,105,72,33,89,117,69,32,85,4798,13.16371681,2502,455,23,0.585069062
Shelvin Mack,202714,2018-19,1247,57,183,61,45,16,63,66,36,17,49,2478,18.4046835,2372,384,34,0.566615303
Dwayne Bacon,1628407,2018-19,759,43,47,26,19,7,14,18,5,11,7,1531,17.32007022,598,95,6,0.672128433
Bismack Biyombo,202687,2018-19,782,54,33,12,9,3,6,34,11,20,14,1549,13.23024055,1106,63,2,0.212390995
Tony Parker,2225,2018-19,1003,56,207,88,65,23,76,75,28,34,41,2071,25.49441101,1618,383,19,0.895281403
Michael Kidd-Gilchrist,203077,2018-19,1179,64,61,37,31,6,19,42,7,26,16,2381,15.88474326,1177,131,6,0.680126353
Kemba Walker,202689,2018-19,2863,82,484,196,122,74,184,211,90,60,151,5835,31.44501666,4563,865,84,0.704942929
Joe Chealey,1629147,2018-19,8,1,1,1,1,0,0,0,0,0,0,16,17.64705882,9,1,0,0
Cody Zeller,203469,2018-19,1243,49,102,40,31,9,38,62,17,40,22,2564,16.26943005,1936,155,11,0.517853273
Willy Hernangomez,1626195,2018-19,812,58,60,24,16,8,26,58,17,27,31,1697,21.28966223,1419,108,7,0.530953943
Frank Kaminsky,1626163,2018-19,755,47,63,24,12,12,24,41,10,22,19,1552,22.22867092,1175,110,10,0.513412269
J.P. Macura,1629122,2018-19,17,2,2,0,0,0,1,0,0,0,0,36,21.95121951,19,5,1,0
Shaquille Harrison,1627885,2018-19,1417,72,139,51,30,21,57,60,25,23,37,2935,16.44716692,1777,238,9,0.539983604
Cristiano Felicio,1626245,2018-19,746,60,37,10,8,2,14,33,9,19,14,1530,14.13612565,984,52,3,0.296451796
Timothe Luwawu-Cabarrot,1627789,2018-19,669,50,26,2,0,2,15,21,5,11,10,1407,15.98489616,479,61,0,0.380312172
Zach LaVine,203897,2018-19,2130,62,283,87,64,23,106,215,86,81,134,4465,30.23958124,2265,533,40,0.626448357
Antonio Blakeney,1628469,2018-19,829,57,42,17,17,0,15,35,13,10,25,1703,24.60063898,432,78,4,0.46512101
Wayne Selden,1627782,2018-19,1439,75,109,26,16,10,57,79,29,36,43,2932,18.36485662,1106,187,8,0.54572907
Chandler Hutchison,1628990,2018-19,895,44,34,10,8,2,16,25,11,10,15,1828,12.41991129,874,64,7,0.376107474
Rawle Alkins,1628959,2018-19,120,10,13,5,3,2,6,8,1,5,3,250,17.80821918,64,20,0,0.387820513
Otto Porter Jr.,203490,2018-19,1649,55,120,35,25,10,71,65,27,24,41,3547,18.9148073,1590,224,15,0.616463996
Lauri Markkanen,1628374,2018-19,1654,51,75,29,20,9,29,85,18,37,48,3417,25.04565614,2346,140,16,0.396084039
Walter Lemon Jr.,1627215,2018-19,167,6,30,12,9,3,15,10,8,2,8,345,25.8974359,284,55,1,0.3
Kris Dunn,1627739,2018-19,1364,45,277,108,80,28,105,104,37,55,49,2828,20.24073487,2398,438,6,0.782335033
Wendell Carter Jr.,1628976,2018-19,1092,43,78,39,27,12,27,65,12,40,25,2249,19.50925181,1215,146,1,0.638479627
Robin Lopez,201577,2018-19,1578,73,89,29,21,8,32,96,11,59,37,3284,18.72607983,1387,142,5,0.415954264
Brandon Sampson,1629102,2018-19,214,14,10,6,5,1,3,12,4,5,7,438,15.59251559,105,14,1,0.372222222
Denzel Valentine,1627756,2018-19,0,0,0,0,0,0,0,0,0,0,0,0,0,0,0,0,0
Ryan Arcidiacono,1627853,2018-19,1939,80,269,95,67,28,102,63,24,28,35,3980,11.95553539,2730,447,15,0.608090954
Kevin Love,201567,2018-19,598,22,48,16,12,4,25,42,17,16,26,1219,26.5480427,817,99,5,0.601210997
Nik Stauskas,203917,2018-19,1015,68,81,31,16,15,38,51,24,16,35,2084,17.69949066,938,166,14,0.630279428
Collin Sexton,1629012,2018-19,2605,82,243,93,76,17,87,185,52,84,101,5246,25.34453782,3733,460,44,0.525234207
Marquese Chriss,1627737,2018-19,499,43,22,12,11,1,6,36,9,23,13,1015,20.30848329,627,50,3,0.364478114
Jaron Blossomgame,1628417,2018-19,439,27,13,8,8,0,4,11,5,5,6,872,12.5,536,27,5,0.407925408
JR Smith,2747,2018-19,222,11,21,4,2,2,13,11,7,3,8,458,18.25242718,224,32,3,0.233766234
Jordan Clarkson,203903,2018-19,2215,81,196,94,59,35,73,135,48,57,78,4469,27.38916256,2157,373,23,0.667437541
Channing Frye,101112,2018-19,341,36,20,9,8,1,7,13,5,6,7,685,17.84776903,457,56,1,0.287179487
David Nwaba,1628021,2018-19,984,51,54,24,20,4,22,29,11,12,17,1954,14.64713715,727,106,2,0.576644474
Tristan Thompson,202684,2018-19,1198,43,86,31,29,2,27,59,14,28,31,2365,17.95154185,1503,150,12,0.390953109
Cedi Osman,1626224,2018-19,2444,76,195,81,56,25,69,114,47,45,69,4898,18.68449584,2766,378,25,0.52546697
Matthew Dellavedova,203521,2018-19,812,48,181,54,39,15,101,68,39,24,44,1657,17.87051899,1474,337,12,0.950988193
Brandon Knight,202688,2018-19,737,39,71,37,26,11,21,30,11,16,14,1480,18.34034877,902,137,9,0.665785958
Larry Nance Jr.,1626204,2018-19,1795,67,214,92,68,24,75,96,29,52,44,3576,15.59655597,2531,394,11,0.669431024
John Henson,203089,2018-19,188,14,14,4,4,0,10,12,3,9,3,414,17.91044776,210,35,3,0.583333333
Deng Adel,1629061,2018-19,194,19,5,2,2,0,0,6,2,2,4,381,10.06864989,153,14,0,-0.155555556
Ante Zizic,1627790,2018-19,1082,59,53,26,23,3,13,61,6,37,24,2179,18.4114053,878,80,2,0.436421509
Courtney Lee,201584,2018-19,428,34,37,21,15,6,8,14,6,7,7,888,15.47131148,314,82,6,0.283783784
Daryl Macon,1629133,2018-19,90,8,7,3,3,0,3,6,4,2,4,185,16.98113208,103,24,1,0.301587302
J.J. Barea,200826,2018-19,752,38,211,78,61,17,112,72,36,24,48,1565,27.37961926,1685,367,24,1.050754447
Kristaps Porzingis,204001,2018-19,0,0,0,0,0,0,0,0,0,0,0,0,0,0,0,0,0
Dwight Powell,203939,2018-19,1663,77,112,47,36,11,33,67,16,46,21,3384,17.35928459,2050,192,10,0.485587304
Dorian Finney-Smith,1627827,2018-19,1985,81,95,46,38,8,34,74,27,39,35,4040,14.04994571,1780,196,14,0.559967186
Tim Hardaway Jr.,203501,2018-19,2032,64,159,69,51,18,64,105,36,37,68,4248,25.10434057,2022,329,23,0.611891275
Jalen Brunson,1628973,2018-19,1591,73,230,95,68,27,91,88,40,29,59,3253,19.20043514,2519,450,33,0.713360769
Trey Burke,203504,2018-19,1125,58,159,68,58,10,58,49,22,22,27,2302,24.93287303,1783,331,18,0.755310426
Devin Harris,2734,2018-19,1071,68,122,53,40,13,46,56,24,22,34,2166,18.82113821,1223,232,15,0.682078571
Kostas Antetokounmpo,1628961,2018-19,11,2,0,0,0,0,0,1,0,0,1,22,24,10,0,0,0
Dirk Nowitzki,1717,2018-19,795,51,35,13,9,4,12,18,4,7,11,1626,22.66960838,922,72,8,0.345905821
Maxi Kleber,1628467,2018-19,1502,71,70,40,31,9,24,54,26,20,34,3039,13.69546374,2017,140,10,0.533694907
Justin Jackson,1628382,2018-19,1613,81,96,26,22,4,45,28,8,11,17,3395,14.37582129,1443,156,12,0.408691353
Ryan Broekhoff,1629151,2018-19,454,42,22,8,6,2,11,16,9,5,11,930,14.38223938,409,44,3,0.301136364
Salah Mejri,1626257,2018-19,399,36,35,11,8,3,7,21,3,11,10,811,16.03053435,594,50,1,0.022222222
Luka Doncic,1629029,2018-19,2318,72,429,190,110,80,193,247,118,91,156,4770,30.54059075,4148,845,59,0.917165271
Isaiah Thomas,202738,2018-19,181,12,23,7,5,2,10,18,8,7,11,390,28.35164835,227,36,1,0.202093398
Michael Porter Jr.,1629008,2018-19,0,0,0,0,0,0,0,0,0,0,0,0,0,0,0,0,0
Torrey Craig,1628470,2018-19,1503,75,72,32,23,9,25,44,14,26,18,3015,12.51428571,1029,142,16,0.554445465
Paul Millsap,200794,2018-19,1895,70,141,60,48,12,54,95,27,39,56,3839,19.63038089,1931,253,20,0.543215509
Will Barton,203115,2018-19,1189,43,124,38,23,15,51,65,22,25,40,2424,20.02164502,1419,240,16,0.550263884
Brandon Goodwin,1629164,2018-19,57,16,14,8,5,3,3,3,1,1,2,122,22.62773723,82,18,2,0.23015873
Trey Lyles,1626168,2018-19,1120,64,87,29,24,5,39,68,22,29,39,2282,23.78190255,1431,157,11,0.50699145
Jarred Vanderbilt,1629020,2018-19,69,17,3,0,0,0,2,8,2,6,2,159,18.18181818,72,9,0,0.25
Monte Morris,1628420,2018-19,1970,82,297,123,94,29,123,52,25,20,32,3966,17.32335461,3486,562,36,0.736316771
Gary Harris,203914,2018-19,1639,57,127,44,37,7,57,68,22,33,35,3342,19.9739922,1199,233,26,0.626862091
Nikola Jokic,203999,2018-19,2504,80,580,173,122,51,265,248,84,109,139,5056,27.58205877,5702,894,40,0.74882697
Tyler Lydon,1628399,2018-19,94,25,6,5,3,2,0,4,1,3,1,205,9.829059829,78,12,0,0.416666667
Mason Plumlee,203486,2018-19,1731,82,243,83,61,22,96,125,48,60,65,3466,16.51976832,2395,400,12,0.628053762
Malik Beasley,1627736,2018-19,1879,81,97,31,24,7,45,55,18,21,34,3840,18.68433074,1139,159,29,0.468326831
Jamal Murray,1627750,2018-19,2447,75,363,135,103,32,129,158,68,49,109,4954,24.87247142,4166,646,83,0.583043129
Juancho Hernangomez,1627823,2018-19,1358,70,55,25,19,6,19,37,8,12,25,2749,12.18819072,1182,93,11,0.388604708
Thomas Welsh,1629118,2018-19,36,11,5,1,1,0,2,1,0,0,1,87,15.30612245,37,7,0,-0.066666667
Andre Drummond,203083,2018-19,2647,79,112,50,38,12,40,175,24,103,72,5335,23.15875614,2785,199,7,0.479728906
Reggie Jackson,202704,2018-19,2289,82,344,133,86,47,158,148,68,57,91,4609,24.34749476,4139,622,52,0.729654171
Luke Kennard,1628379,2018-19,1437,63,114,57,38,19,42,57,23,25,32,2863,18.52651048,1351,242,29,0.695486192
Bruce Brown,1628971,2018-19,1449,74,91,46,34,12,33,45,20,15,30,2885,11.70924574,1308,204,23,0.609326365
Thon Maker,1627748,2018-19,972,64,45,17,10,7,17,33,6,21,12,1978,15.31895777,1156,75,4,0.443049488
Langston Galloway,204038,2018-19,1745,80,85,35,20,15,33,24,12,8,16,3547,15.88554514,1222,180,20,0.494895816
Isaiah Whitehead,1627785,2018-19,0,0,0,0,0,0,0,0,0,0,0,0,0,0,0,0,0
Khyri Thomas,1629017,2018-19,195,26,8,3,2,1,5,4,1,1,3,396,16.55913978,155,28,3,0.416666667
Ish Smith,202397,2018-19,1251,56,203,106,69,37,69,61,22,21,40,2514,19.97926028,2293,421,24,0.83028944
Svi Mykhailiuk,1629004,2018-19,440,42,37,7,4,3,22,21,12,4,17,938,16.15969582,350,53,5,0.180609181
Wayne Ellington,201961,2018-19,1297,53,72,21,13,8,40,40,19,16,24,2613,17.0360569,935,145,11,0.580765556
Glenn Robinson III,203922,2018-19,610,47,21,14,9,5,4,18,7,5,13,1227,15.07823613,634,56,6,0.463200137
Blake Griffin,201933,2018-19,2622,75,402,203,159,44,125,253,81,119,134,5316,30.3165183,4577,823,51,0.799733612
Kalin Lucas,203564,2018-19,6,1,1,0,0,0,1,0,0,0,0,11,16.66666667,10,2,0,0
Zaza Pachulia,2585,2018-19,878,68,91,24,20,4,33,57,7,41,16,1751,15.31936128,1099,155,3,0.517047934
Jon Leuer,202720,2018-19,402,41,14,4,3,1,3,23,2,16,7,809,16.38981174,441,29,0,0.065217391
Jose Calderon,101181,2018-19,632,49,115,52,31,21,45,35,19,12,23,1289,10.86065574,1287,225,12,0.821935142
DeMarcus Cousins,202326,2018-19,771,30,107,41,36,5,47,72,20,39,33,1610,28.69318182,1116,183,8,0.737651376
Damion Lee,1627814,2018-19,375,32,13,6,6,0,6,11,3,7,4,787,16.81818182,366,43,2,0.468531469
Jordan Bell,1628395,2018-19,788,68,76,29,18,11,21,42,8,26,16,1625,13.83095499,1232,155,14,0.520089472
Quinn Cook,1626188,2018-19,1059,74,116,29,20,9,44,50,20,24,26,2172,20.62111801,1880,234,12,0.468074936
Kevon Looney,1626172,2018-19,1481,80,123,54,38,16,21,51,14,30,21,3099,12.51059023,1773,225,7,0.417995791
Andre Iguodala,2738,2018-19,1578,68,216,73,50,23,90,52,21,27,25,3305,10.45182363,2131,378,21,0.677965123
Jacob Evans,1628980,2018-19,204,30,23,6,5,1,7,11,5,2,9,422,13.67521368,245,29,5,-0.040843215
Klay Thompson,202691,2018-19,2652,78,186,49,23,26,96,115,36,58,57,5541,25.93259162,1919,295,32,0.545981869
Andrew Bogut,101106,2018-19,134,11,11,3,3,0,6,8,2,4,4,280,15.15151515,195,19,3,0.318181818
Damian Jones,1627745,2018-19,410,24,28,6,3,3,5,16,3,11,5,838,11.52173913,409,42,4,-0.044642857
Jonas Jerebko,201973,2018-19,1218,73,96,39,32,7,21,43,19,19,24,2531,14.92227979,1699,202,9,0.39035927
Draymond Green,203110,2018-19,2065,66,454,161,122,39,178,169,92,63,106,4354,13.1496556,3869,755,40,0.76504802
Alfonzo McKinnie,1628035,2018-19,1003,72,31,14,12,2,11,30,10,16,14,2112,13.46313173,937,52,5,0.424903455
Stephen Curry,201939,2018-19,2331,69,361,121,82,39,153,192,92,65,127,4997,29.63163597,3477,623,69,0.651628045
Marcus Derrickson,1629094,2018-19,67,11,1,1,1,0,0,3,2,1,2,138,23.60248447,49,7,0,0.444444444
Shaun Livingston,2733,2018-19,967,64,114,47,35,12,37,38,18,16,22,1975,12.15121512,1556,232,22,0.599543843
Kevin Durant,201142,2018-19,2702,78,457,194,152,42,167,225,91,90,135,5714,28.90118577,3398,834,64,0.810699766
Trevon Duval,1628979,2018-19,6,3,2,1,1,0,1,0,0,0,0,12,25,14,3,0,0
Iman Shumpert,202697,2018-19,1481,62,112,42,28,14,46,50,20,18,32,3147,14.55571227,1286,202,20,0.532518152
Chris Chiozza,1629185,2018-19,33,7,4,2,2,0,1,1,1,0,1,73,10.97560976,50,15,1,0.083333333
Chris Paul,101108,2018-19,1857,58,473,235,160,75,195,152,85,47,105,3788,22.61567517,2949,907,37,1.14147849
Danuel House Jr.,1627863,2018-19,979,39,40,21,13,8,16,35,9,18,17,1997,14.108252,673,75,3,0.617811997
Gary Clark,1629109,2018-19,641,51,18,12,9,3,6,7,5,1,6,1312,10.76716016,512,44,3,0.535532627
Eric Gordon,201569,2018-19,2158,68,129,60,26,34,59,90,27,44,46,4395,21.99153396,1478,265,19,0.720872151
Vincent Edwards,1629053,2018-19,16,2,0,0,0,0,0,0,0,0,0,33,11.11111111,8,1,0,0
James Harden,201935,2018-19,2867,78,586,218,135,83,336,387,171,131,256,5778,40.35303147,3864,1079,69,1.047155482
Gerald Green,101123,2018-19,1473,73,40,19,8,11,18,55,21,21,34,3014,19.56586381,1092,89,10,0.527528802
Clint Capela,203991,2018-19,2249,67,96,51,29,22,28,94,18,49,45,4501,18.3989039,3008,172,12,0.463668151
PJ Tucker,200782,2018-19,2802,82,96,55,36,19,29,62,19,40,22,5636,9.641959799,2296,209,10,0.58900455
Michael Frazier,1626187,2018-19,0,0,0,0,0,0,0,0,0,0,0,0,0,0,0,0,0
Austin Rivers,203085,2018-19,2028,76,167,88,56,32,49,68,22,31,37,4178,14.604811,1844,316,22,0.632838534
Kenneth Faried,202702,2018-19,728,37,20,13,9,4,5,33,13,14,19,1515,19.98834499,842,54,7,0.513056316
Nene ,2403,2018-19,546,42,26,18,13,5,4,11,4,6,5,1121,11.89320388,598,62,4,0.578537405
Isaiah Hartenstein,1628392,2018-19,221,28,15,11,8,3,3,13,1,11,2,461,11.47227533,241,25,1,0.548717949
Darren Collison,201954,2018-19,2143,76,459,149,118,31,167,125,65,37,88,4356,17.92918897,3811,854,45,0.743048091
Aaron Holiday,1628988,2018-19,646,50,87,21,12,9,39,40,19,13,27,1355,21.32013201,778,154,16,0.567655377
Victor Oladipo,203506,2018-19,1147,36,186,57,33,24,73,82,36,25,57,2309,28.26254826,1389,289,28,0.593909075
Edmond Sumner,1628410,2018-19,210,23,10,1,0,1,4,10,3,6,4,455,16.15384615,189,33,3,0.033333333
Cory Joseph,202709,2018-19,2063,82,321,106,78,28,135,80,47,24,56,4166,13.79604003,3393,566,43,0.62528391
Kyle O'Quinn,203124,2018-19,371,45,56,17,14,3,28,30,11,16,14,786,20.04555809,639,68,2,0.31468254
Domantas Sabonis,1627734,2018-19,1838,74,212,69,51,18,85,160,43,91,69,3721,23.30097087,3703,367,27,0.54811415
Doug McDermott,203926,2018-19,1340,77,67,17,14,3,32,42,19,19,23,2729,15.79116984,1020,108,9,0.401949636
Thaddeus Young,201152,2018-19,2489,81,204,70,46,24,92,123,44,55,68,4968,18.33512738,2947,353,21,0.538109327
TJ Leaf,1628388,2018-19,522,58,24,9,6,3,8,12,2,6,6,1106,16.58692185,420,44,2,0.397386426
Wesley Matthews,202083,2018-19,2091,69,160,60,41,19,78,91,36,34,57,4284,17.95193312,1548,256,21,0.608179594
Alize Johnson,1628993,2018-19,64,14,1,0,0,0,1,0,0,0,0,147,11.83431953,63,1,1,0
Davon Reed,1628432,2018-19,47,10,3,2,1,1,0,1,1,0,1,105,10.56910569,48,5,0,0
Myles Turner,1626167,2018-19,2119,74,115,37,23,14,50,100,27,53,47,4275,20.37076048,2726,168,11,0.40743318
Bojan Bogdanovic,202711,2018-19,2573,81,161,59,35,24,71,134,41,65,69,5223,22.39342578,2031,286,31,0.554449918
Sindarius Thornwell,1628414,2018-19,313,64,18,7,6,1,7,20,8,9,11,675,11.30319149,229,31,1,0.261111111
Shai Gilgeous-Alexander,1628983,2018-19,2174,82,270,114,85,29,114,141,65,55,86,4566,18.63268129,3332,510,35,0.695453259
JaMychal Green,203210,2018-19,1371,65,50,11,9,2,25,86,35,42,44,2811,19.15563957,1853,99,6,0.341760972
Montrezl Harrell,1626149,2018-19,2158,82,162,57,36,21,58,132,32,63,69,4576,23.3346395,2635,239,12,0.403753568
Danilo Gallinari,201568,2018-19,2059,68,178,63,40,23,67,99,41,40,59,4287,24.12638627,2744,330,26,0.478884914
Tyrone Wallace,1627820,2018-19,628,62,42,14,11,3,18,36,14,16,20,1372,18,811,87,9,0.489196244
Jerome Robinson,1629010,2018-19,321,33,19,6,2,4,9,13,11,2,11,685,16.47058824,255,32,4,0.174089069
Johnathan Motley,1628405,2018-19,156,22,11,2,1,1,4,16,2,11,5,338,27.20207254,226,18,0,0.107954545
Garrett Temple,202066,2018-19,2041,75,106,36,30,6,34,70,30,29,41,4121,13.45430405,2017,224,37,0.352612076
Rodney McGruder,203585,2018-19,1550,66,112,41,33,8,55,64,30,21,43,3179,15.11280239,1495,227,7,0.598142268
Landry Shamet,1629013,2018-19,1787,78,117,41,30,11,52,45,21,20,25,3794,14.87913635,1297,180,22,0.515862557
Patrick Beverley,201976,2018-19,2137,78,300,119,89,30,113,85,42,37,48,4463,12.2939424,3062,496,26,0.645851412
Wilson Chandler,201163,2018-19,1142,50,82,28,23,5,38,46,22,20,26,2467,11.86012978,1135,128,9,0.507998312
Lou Williams,101150,2018-19,1993,75,402,113,81,32,242,181,108,42,139,4308,31.63794893,2617,641,41,0.860328617
Angel Delgado,1629116,2018-19,15,2,0,0,0,0,0,0,0,0,0,31,15.78947368,13,0,0,0
Ivica Zubac,1627826,2018-19,1039,59,63,20,18,2,20,70,9,36,34,2212,20.42793702,1516,81,6,0.271072195
Kyle Kuzma,1628398,2018-19,2314,70,178,62,45,17,100,133,34,73,60,4954,23.80524614,2099,301,23,0.699882494
Kentavious Caldwell-Pope,203484,2018-19,2035,82,110,31,20,11,66,65,27,24,41,4325,17.98191533,1923,217,18,0.557706859
Lonzo Ball,1628366,2018-19,1423,47,255,61,45,16,160,103,51,39,64,3055,17.00819672,2382,447,22,0.827996111
Josh Hart,1628404,2018-19,1715,67,93,45,28,17,37,58,17,30,28,3682,13.3655006,1442,168,21,0.601931595
Alex Caruso,1627936,2018-19,531,25,77,19,16,3,41,42,21,13,29,1108,19.23076923,724,131,11,0.643372274
Tyson Chandler,2199,2018-19,875,55,37,14,10,4,11,42,8,31,11,1858,8.705994291,857,63,7,0.400553007
Lance Stephenson,202362,2018-19,1123,68,140,41,30,11,74,86,34,38,48,2419,20.36968577,1304,258,12,0.72964325
JaVale McGee,201580,2018-19,1671,75,52,20,16,4,24,108,31,58,50,3567,20.22862823,1604,94,10,0.473356757
Rajon Rondo,200765,2018-19,1369,46,367,127,95,32,180,127,64,56,71,2922,17.63262803,2620,679,28,1.071969997
Jemerrio Jones,1629203,2018-19,143,6,13,8,8,0,3,5,1,3,2,295,10.95505618,172,20,2,0.379487179
Brandon Ingram,1627742,2018-19,1761,52,154,48,34,14,79,129,42,52,77,3761,23.22565433,2026,332,29,0.644774522
Moritz Wagner,1629021,2018-19,446,43,24,9,6,3,9,39,13,15,24,959,21.56862745,434,39,4,0.211538462
Isaac Bonga,1629067,2018-19,120,22,15,4,4,0,8,6,3,2,4,257,15.80756014,114,23,0,0.244444444
Johnathan Williams,1629140,2018-19,372,24,13,6,5,1,6,16,0,11,5,766,16.44295302,288,32,1,0.485576923
LeBron James,2544,2018-19,1937,55,454,146,105,41,245,197,83,83,114,4142,31.8388564,3016,892,40,1.091268651
Mike Muscala,203488,2018-19,1288,63,76,34,29,5,32,48,21,23,25,2784,14.29489239,1901,156,10,0.564656693
Reggie Bullock,203493,2018-19,1879,63,129,49,32,17,53,65,28,24,41,3884,15.70285714,1704,181,17,0.449656422
Avery Bradley,202340,2018-19,1905,63,152,49,42,7,73,89,53,27,62,3937,16.38559708,1428,245,18,0.537266059
Kyle Anderson,203937,2018-19,1282,43,128,39,24,15,60,58,20,29,29,2520,13.04190751,1504,234,30,0.611549907
Delon Wright,1626153,2018-19,1698,75,248,126,77,49,64,77,30,28,49,3496,17.77665232,2786,497,38,0.691763738
Jevon Carter,1628975,2018-19,576,39,69,27,24,3,27,33,12,15,18,1147,17.85440613,876,129,10,0.638675788
Julian Washburn,1627395,2018-19,254,18,14,5,3,2,7,7,2,3,4,496,9.930313589,228,33,1,0.333333333
Bruno Caboclo,203998,2018-19,800,34,50,20,15,5,20,38,12,16,22,1616,15.52287582,804,75,3,0.460717793
CJ Miles,101139,2018-19,857,53,36,6,4,2,23,30,11,13,17,1813,17.91338583,643,63,7,0.454823812
Justin Holiday,203200,2018-19,2568,81,146,53,35,18,69,104,55,34,70,5292,15.66592958,1968,265,31,0.515771749
Ivan Rabb,1628397,2018-19,721,49,54,20,16,4,27,35,10,15,20,1434,17.11990111,966,94,4,0.574243815
Mike Conley,201144,2018-19,2342,70,449,143,103,40,196,130,71,34,96,4672,27.02650788,4158,868,66,0.754901564
Yuta Watanabe,1629139,2018-19,174,15,8,4,3,1,4,6,1,5,1,358,15.19607843,156,18,0,0.611111111
Jaren Jackson Jr.,1628991,2018-19,1515,58,64,24,17,7,26,98,14,58,40,2962,23.63747704,1531,125,5,0.476016479
Jonas Valanciunas,202685,2018-19,1091,49,70,26,19,7,24,90,27,45,45,2262,28.26086957,1747,123,13,0.39743273
Tyler Dorsey,1628416,2018-19,698,48,56,26,15,11,24,27,8,15,12,1465,18.97590361,603,134,8,0.825574961
Dillon Brooks,1628415,2018-19,330,18,16,8,7,1,7,19,10,8,11,647,21.418637,274,33,2,0.411184211
Chandler Parsons,202718,2018-19,496,25,43,18,8,10,16,32,14,14,18,1003,20,587,88,4,0.269864341
Tyler Zeller,203092,2018-19,93,6,4,0,0,0,3,4,0,3,1,190,19.6347032,84,7,0,0.333333333
Joakim Noah,201149,2018-19,693,42,89,22,15,7,37,50,16,22,28,1392,19.82378855,1321,160,4,0.494921943
Kendrick Nunn,1629134,2018-19,0,0,0,0,0,0,0,0,0,0,0,0,0,0,0,0,0
Josh Richardson,1626196,2018-19,2539,73,298,119,81,38,118,113,42,52,61,5130,20.94089674,3475,539,43,0.649423893
Yante Maten,1628999,2018-19,13,2,0,0,0,0,0,0,0,0,0,27,13.33333333,15,0,0,0
Dwyane Wade,2548,2018-19,1885,72,301,102,69,33,148,166,82,55,111,3883,27.7214334,2583,585,34,0.811165548
Derrick Jones Jr.,1627884,2018-19,1154,60,37,22,13,9,10,43,15,21,22,2301,15.68113772,1034,87,7,0.520518109
Goran Dragic,201609,2018-19,991,36,174,56,43,13,87,71,31,28,43,2074,22.93423272,1509,295,24,0.779800629
Kelly Olynyk,203482,2018-19,1812,79,140,68,40,28,50,114,31,69,45,3678,17.97323136,2839,298,13,0.647370561
Dion Waiters,203079,2018-19,1138,44,121,60,36,24,41,64,25,33,31,2277,21.88841202,1382,227,21,0.70364654
Bam Adebayo,1628389,2018-19,1913,82,184,90,62,28,53,121,20,78,43,3859,16.21062313,2069,346,15,0.673481573
James Johnson,201949,2018-19,1164,55,135,66,54,12,50,74,20,41,33,2350,18.20917983,1585,282,10,0.7974633
Justise Winslow,1626159,2018-19,1960,66,282,116,80,36,119,142,76,44,98,3980,21.09219545,3448,492,30,0.663664875
Hassan Whiteside,202355,2018-19,1674,72,56,19,17,2,19,97,14,66,31,3380,22.12948912,1342,117,9,0.395784667
Ryan Anderson,201583,2018-19,321,25,19,7,4,3,9,14,6,7,7,645,12.43093923,543,39,3,0.342105263
Udonis Haslem,2617,2018-19,75,10,2,0,0,0,2,3,1,2,1,162,21.11111111,80,7,0,0.555555556
Duncan Robinson,1629130,2018-19,161,15,5,0,0,0,3,4,2,2,2,336,13.82978723,142,9,1,0.1
George Hill,201588,2018-19,1302,60,135,46,29,17,60,51,18,24,27,2681,15.18945634,1696,235,12,0.594434136
D.J. Wilson,1628391,2018-19,882,48,52,28,20,8,14,32,16,13,19,1873,14.53765491,1033,95,6,0.476117208
Eric Bledsoe,202339,2018-19,2272,78,430,166,132,34,226,165,65,65,100,4854,22.95813953,2975,745,48,0.954599469
Donte DiVincenzo,1628978,2018-19,411,27,31,10,8,2,17,19,6,9,10,887,14.8445336,465,67,2,0.362195812
Brook Lopez,201572,2018-19,2322,81,98,45,34,11,37,82,27,42,40,4970,16.86152722,1981,153,10,0.483924928
Tim Frazier,204025,2018-19,1120,59,248,89,67,22,112,76,24,35,41,2378,13.53271028,2177,440,25,0.892296119
Malcolm Brogdon,1627763,2018-19,1832,64,205,90,61,29,91,91,38,41,50,3883,20.83140878,2340,397,31,0.752804489
Pau Gasol,2200,2018-19,361,30,52,16,10,6,17,16,6,3,13,755,15.77669903,740,96,1,0.030448718
Tony Snell,203503,2018-19,1304,74,68,20,13,7,38,23,10,9,14,2755,13.08196721,1079,131,9,0.538578127
Khris Middleton,203114,2018-19,2393,77,331,108,82,26,191,174,74,60,114,5130,25.09264161,2728,539,31,0.774420054
Sterling Brown,1628425,2018-19,1034,58,84,30,24,6,43,46,22,19,27,2219,15.34693878,916,150,6,0.648885269
Pat Connaughton,1626192,2018-19,1261,61,122,53,39,14,48,33,11,17,16,2683,13.33998669,1405,188,8,0.615815212
Giannis Antetokounmpo,203507,2018-19,2358,72,424,245,179,66,135,268,49,165,103,5053,32.27248346,3911,829,46,0.998319004
Nikola Mirotic,202703,2018-19,1245,46,55,17,13,4,27,48,17,25,23,2702,21.14060964,1571,94,11,0.442280953
Bonzie Colson,1629045,2018-19,98,8,3,0,0,0,3,3,0,2,1,225,17.62452107,90,6,0,0.555555556
Ersan Ilyasova,101141,2018-19,1231,67,52,25,19,6,21,47,14,29,18,2606,15.58704453,1399,86,11,0.554956858
Jeff Teague,201952,2018-19,1264,42,343,119,84,35,144,97,43,38,59,2640,18.91538713,2225,567,20,0.934088784
Tyus Jones,1626145,2018-19,1560,68,327,127,104,23,121,47,30,14,33,3244,14.31318681,3001,613,45,0.788247862
Jared Terrell,1629123,2018-19,111,14,12,7,5,2,5,10,6,3,7,230,20.23346304,163,27,2,0.433333333
Gorgui Dieng,203476,2018-19,1031,76,72,28,23,5,27,57,12,30,27,2127,20.2606137,1425,132,6,0.493323435
Jerryd Bayless,201573,2018-19,657,34,119,51,40,11,47,32,18,9,23,1327,17.83148269,1163,219,13,0.772252183
Luol Deng,2736,2018-19,392,22,18,4,2,2,10,14,4,7,7,809,15.84051724,353,35,2,0.277777778
C.J. Williams,203710,2018-19,128,15,12,3,2,1,4,5,0,5,0,258,14.33691756,109,22,1,0.25
Cameron Reynolds,1629244,2018-19,259,19,13,5,4,1,5,5,0,4,1,536,14.4278607,207,22,3,0.369230769
Josh Okogie,1629006,2018-19,1757,74,91,22,10,12,49,63,25,30,33,3712,15.23742027,1048,165,23,0.523636094
Andrew Wiggins,203952,2018-19,2543,73,184,86,55,31,53,138,39,59,79,5277,24.58063445,1895,349,27,0.55268854
Derrick Rose,201565,2018-19,1392,51,220,65,51,14,104,82,33,26,56,2939,26.84163436,1643,393,26,0.728730386
Keita Bates-Diop,1628966,2018-19,503,30,17,3,2,1,9,14,4,5,9,1031,14.48157669,316,28,1,0.302536904
Karl-Anthony Towns,1626157,2018-19,2545,77,259,79,57,22,138,240,64,142,98,5286,28.57142857,3781,474,33,0.680004598
Robert Covington,203496,2018-19,1203,35,46,17,10,7,19,46,13,28,18,2487,15.65585331,907,89,10,0.490947981
Dario Saric,203967,2018-19,2022,81,127,45,26,19,50,97,28,43,54,4221,17.83479349,2729,253,16,0.446962744
Anthony Tolliver,201229,2018-19,1079,65,46,10,6,4,18,36,12,20,16,2242,12.52453867,1103,71,4,0.257385739
Mitchell Creek,1628249,2018-19,47,5,6,2,2,0,2,1,1,0,1,98,17.54385965,37,6,1,0
Taj Gibson,201959,2018-19,1686,70,84,32,27,5,28,73,12,42,31,3494,17.08829365,2028,137,13,0.388211524
Ian Clark,203546,2018-19,973,60,94,22,14,8,46,58,18,22,36,2092,19.1480388,1132,173,13,0.513801842
Stanley Johnson,1626169,2018-19,1207,66,88,44,29,15,28,81,27,37,44,2499,19.42573555,1666,182,10,0.563809299
Elfrid Payton,203901,2018-19,1250,42,320,103,81,22,138,112,57,36,76,2697,18.18181818,2328,547,26,0.866166826
Trevon Bluiett,1629129,2018-19,0,0,0,0,0,0,0,0,0,0,0,0,0,0,0,0,0
Jahlil Okafor,1626143,2018-19,935,59,40,9,5,4,20,52,4,31,21,1968,20.33514493,1143,82,8,0.416492849
Dairis Bertans,1629541,2018-19,167,12,10,3,3,0,5,2,1,1,1,361,12.37373737,139,13,0,0.3
Jrue Holiday,201950,2018-19,2402,67,518,161,110,51,272,210,110,57,153,5128,25.39491758,4045,934,41,0.879461839
Cheick Diallo,1627767,2018-19,896,64,33,15,12,3,13,49,11,25,24,1939,16.07554123,1172,64,3,0.477922289
Frank Jackson,1628402,2018-19,1169,61,69,20,16,4,27,48,26,21,27,2549,18.29861111,1119,125,11,0.378961967
Darius Miller,203121,2018-19,1757,69,146,44,29,15,68,59,28,28,31,3752,13.4392036,1418,271,17,0.604003139
Anthony Davis,203076,2018-19,1850,56,218,80,64,16,100,112,31,52,60,3937,29.32180851,2725,334,22,0.616892659
Julius Randle,203944,2018-19,2232,73,229,97,78,19,83,207,43,109,98,4754,27.9125764,2715,427,26,0.643465529
Kenrich Williams,1629026,2018-19,1079,46,83,30,21,9,36,36,19,12,24,2326,12.14742384,1154,135,14,0.481725417
Christian Wood,1626174,2018-19,250,21,8,4,3,1,3,17,5,7,10,551,25.68659128,262,18,1,0.345588235
Solomon Hill,203524,2018-19,879,44,55,19,18,1,23,31,18,4,27,1863,10.59885932,977,133,2,0.427419768
E'Twaun Moore,202734,2018-19,1463,53,102,31,24,7,49,59,21,21,38,3100,17.41588917,1316,160,14,0.467235994
Kadeem Allen,1628443,2018-19,416,19,76,35,28,7,28,26,6,16,10,841,20.46908316,691,123,3,0.367408907
Emmanuel Mudiay,1626144,2018-19,1576,58,228,108,81,27,94,140,62,48,92,3323,25.51669316,2798,496,40,0.82557425
Luke Kornet,1628436,2018-19,750,45,54,18,13,5,20,25,15,7,18,1631,18.41074426,1010,73,7,0.299980931
Billy Garrett,1628656,2018-19,63,4,7,3,2,1,3,2,1,1,1,133,21.9858156,68,15,2,0.357142857
Isaiah Hicks,1628439,2018-19,32,3,2,1,1,0,1,1,1,0,1,65,15.94202899,36,0,0,0.333333333
Dennis Smith Jr.,1628372,2018-19,1508,53,252,115,82,33,102,154,76,56,98,3121,24.85746864,2785,488,25,0.814488409
DeAndre Jordan,201599,2018-19,2047,69,156,52,40,12,62,153,49,81,72,4199,15.17894737,2610,242,14,0.451515247
Mario Hezonja,1626209,2018-19,1187,57,88,25,19,6,53,88,32,43,45,2475,21.38543517,1513,153,16,0.612595731
Frank Ntilikina,1628373,2018-19,887,42,121,42,35,7,51,56,27,23,33,1859,16.80993314,1293,228,10,0.672213467
Henry Ellenson,1627740,2018-19,259,19,16,8,8,0,7,9,2,4,5,530,19.3877551,374,28,0,0.418981481
Allonzo Trier,1629019,2018-19,1435,63,119,48,38,10,52,116,40,55,61,3009,21.45985401,1338,232,15,0.666781043
Kevin Knox,1628995,2018-19,2127,74,82,39,31,8,29,114,20,67,47,4484,22.41618726,1896,166,17,0.524104995
Damyean Dotson,1628422,2018-19,1978,72,135,67,51,16,43,71,32,26,45,4123,17.44186047,1787,290,20,0.579109772
Mitchell Robinson,1629011,2018-19,1350,65,37,9,8,1,7,35,7,21,14,2778,12.25662305,1129,57,6,0.058475145
John Jenkins,203098,2018-19,333,26,22,7,5,2,12,9,7,2,7,675,16.6437414,249,30,5,0.271043771
Noah Vonleh,203943,2018-19,1697,67,129,57,53,4,31,88,16,51,37,3541,14.82125124,2649,268,11,0.467781698
Lance Thomas,202498,2018-19,783,46,27,9,7,2,13,24,5,15,9,1613,13.17829457,817,45,3,0.469032305
Russell Westbrook,201566,2018-19,2593,72,784,294,196,98,358,325,173,106,219,5668,30.64169481,4325,1498,44,1.197751534
Raymond Felton,101109,2018-19,379,33,52,22,15,7,25,14,5,6,8,787,17.0893054,456,100,3,0.38003663
Nerlens Noel,203457,2018-19,1043,76,45,22,18,4,19,47,14,19,28,2195,14.26863292,1227,96,7,0.549478012
Markieff Morris,202693,2018-19,1271,58,79,32,22,10,38,54,20,24,30,2663,19.49579832,1231,135,11,0.583439947
Hamidou Diallo,1628977,2018-19,522,50,17,8,4,4,8,23,7,15,8,1110,16.44888547,227,23,3,0.637283997
Jawun Evans,1628393,2018-19,64,8,10,2,1,1,5,6,4,1,5,127,14.70588235,113,19,1,0.088888889
Jerami Grant,203924,2018-19,2578,79,79,46,31,15,21,67,14,39,28,5603,15.21907416,2943,150,20,0.484617489
Abdel Nader,1627846,2018-19,686,60,20,6,5,1,8,26,4,16,10,1470,15.31966224,343,39,3,0.409015474
Steven Adams,203500,2018-19,2634,79,124,49,31,18,50,133,35,65,68,5748,16.22760801,2413,229,21,0.476470324
Paul George,202331,2018-19,2801,76,318,124,73,51,150,205,75,80,125,6060,29.1954023,2360,591,23,0.786469656
Donte Grantham,1629055,2018-19,2,3,0,0,0,0,0,0,0,0,0,6,33.33333333,1,0,0,0
Dennis Schroder,203471,2018-19,2288,78,323,119,90,29,167,172,93,47,125,4916,24.41530829,2785,654,36,0.830536125
Andre Roberson,203460,2018-19,0,0,0,0,0,0,0,0,0,0,0,0,0,0,0,0,0
Terrance Ferguson,1628390,2018-19,1902,73,72,33,14,19,27,47,14,26,21,4106,10.67857903,697,116,8,0.57847981
Deonte Burton,1629126,2018-19,240,32,9,7,2,5,2,9,3,4,5,509,16.29502573,163,16,1,0.481481481
Patrick Patterson,202335,2018-19,847,62,31,10,10,0,14,22,10,10,12,1826,12.18103033,927,54,4,0.381048888
Aaron Gordon,203932,2018-19,2567,76,289,99,74,25,118,162,51,85,77,5328,21.87812188,2732,502,27,0.638402693
Jonathan Isaac,1628371,2018-19,1937,73,80,23,18,5,28,75,29,33,42,4036,16.37080868,2568,164,17,0.266029939
Jarell Martin,1626185,2018-19,323,41,18,7,4,3,5,11,1,9,2,686,15.65789474,463,32,2,0.272727273
Troy Caupain,1628505,2018-19,16,4,4,1,1,0,3,0,0,0,0,32,21.62162162,12,3,0,0
Mo Bamba,1628964,2018-19,733,45,39,11,10,1,5,43,10,23,20,1540,18.0974478,871,53,2,0.055039509
Michael Carter-Williams,203487,2018-19,372,28,70,34,29,5,23,20,8,10,10,798,18.20151679,624,152,3,0.314285714
Nikola Vucevic,202696,2018-19,2447,78,307,130,86,44,125,159,40,87,72,5108,28.1184669,3846,548,25,0.712775553
Evan Fournier,203095,2018-19,2490,79,295,111,77,34,93,154,67,58,96,5174,22.13438735,2064,544,43,0.63243967
Amile Jefferson,1628518,2018-19,68,12,3,1,1,0,0,1,0,1,0,147,12.5748503,67,6,0,0
D.J. Augustin,201571,2018-19,2202,79,426,142,105,37,162,128,65,42,86,4609,17.19474498,3656,801,79,0.739175479
Markelle Fultz,1628365,2018-19,427,19,59,27,20,7,20,25,7,12,13,905,19.42800789,758,122,5,0.289943503
Timofey Mozgov,202389,2018-19,0,0,0,0,0,0,0,0,0,0,0,0,0,0,0,0,0
Jerian Grant,1626170,2018-19,910,58,156,54,43,11,42,51,26,20,31,1899,13.48946136,1441,295,14,0.608331672
Khem Birch,203920,2018-19,643,50,38,12,9,3,11,20,7,11,9,1316,14.11290323,701,61,2,0.303816177
Wes Iwundu,1628411,2018-19,1233,68,73,26,20,6,25,44,18,18,26,2531,12.84758888,839,143,11,0.454745399
Terrence Ross,203082,2018-19,2098,79,135,44,29,15,55,90,46,32,58,4389,23.60097324,1435,270,28,0.50203249
Melvin Frazier Jr.,1628982,2018-19,44,10,1,1,1,0,0,1,0,1,0,99,20.51282051,21,3,0,0.666666667
Mike Scott,203118,2018-19,1396,79,66,19,14,5,36,44,15,25,19,2968,14.37125749,1535,94,7,0.484633635
Amir Johnson,101161,2018-19,529,51,60,23,16,7,13,45,14,25,20,1120,17.43264659,822,82,0,0.373284661
Haywood Highsmith,1629312,2018-19,40,5,2,0,0,0,2,1,0,0,1,88,11.65048544,46,4,0,0.333333333
Zhaire Smith,1629015,2018-19,111,6,10,3,3,0,4,6,3,3,3,231,17.05426357,74,12,0,0.2
James Ennis III,203516,2018-19,1230,58,41,14,10,4,19,34,9,20,14,2504,12.88386869,712,72,11,0.493949994
T.J. McConnell,204456,2018-19,1451,75,258,99,78,21,116,91,42,29,62,3062,15.32187591,2808,464,47,0.757915401
Jonathon Simmons,203613,2018-19,1022,54,128,55,48,7,35,68,23,22,46,2189,18.78317681,888,246,18,0.662032999
JJ Redick,200755,2018-19,2346,75,206,58,45,13,110,101,31,51,50,5075,21.51653765,1784,335,31,0.647760664
Shake Milton,1629003,2018-19,268,20,18,3,3,0,10,6,0,4,2,564,15.02347418,236,36,2,0.277777778
Joel Embiid,203954,2018-19,2121,63,234,94,79,15,58,226,51,118,108,4543,33.83133477,3651,426,26,0.474476299
Jimmy Butler,202710,2018-19,2147,64,263,106,72,34,94,95,34,45,50,4570,22.31643862,2163,502,32,0.717584036
Ben Simmons,1627732,2018-19,2664,78,610,260,215,45,240,274,118,108,166,5742,21.95535027,5187,1206,55,0.969599366
Furkan Korkmaz,1627788,2018-19,679,48,52,22,16,6,21,25,9,9,16,1440,17.97752809,589,76,9,0.521217976
Tobias Harris,202699,2018-19,2848,82,229,90,66,24,89,151,46,65,86,5949,22.9618549,3351,457,35,0.555321265
Jonah Bolden,1628413,2018-19,626,43,40,17,16,1,11,36,12,22,14,1364,13.54300385,915,66,5,0.414599494
Boban Marjanovic,1626246,2018-19,681,58,54,11,8,3,26,59,16,30,29,1430,22.92682927,883,80,2,0.396084573
Greg Monroe,202328,2018-19,480,43,24,6,3,3,13,32,2,19,13,1013,21.75408426,564,52,1,0.322916667
Devin Booker,1626164,2018-19,2242,64,433,166,111,55,190,263,114,95,168,4697,32.66398929,2919,807,43,0.91232083
Elie Okobo,1629059,2018-19,958,53,127,44,37,7,55,69,37,26,43,1962,17.30418944,1911,262,26,0.649052181
Kelly Oubre Jr.,1626162,2018-19,1935,69,84,28,23,5,31,103,29,39,64,4104,22.8154282,1538,164,19,0.35331439
George King,1628994,2018-19,0,0,0,0,0,0,0,0,0,0,0,0,0,0,0,0,0
Jamal Crawford,2037,2018-19,1211,64,229,43,30,13,140,99,52,32,67,2564,20.47299682,1752,407,18,0.808595894
T.J. Warren,203933,2018-19,1360,43,64,31,21,10,26,52,17,22,30,2838,22.60924636,1887,159,14,0.56615647
De'Anthony Melton,1629001,2018-19,984,50,159,49,32,17,71,75,35,27,48,2055,14.99781373,1874,299,20,0.671463864
Tyler Johnson,204020,2018-19,1529,57,166,64,39,25,64,77,33,30,47,3142,18.53617499,2015,319,15,0.601233549
Josh Jackson,1628367,2018-19,1988,79,183,30,22,8,124,173,89,64,109,4138,24.02077472,1991,317,15,0.616850668
Richaun Holmes,1626158,2018-19,1184,70,60,23,20,3,19,52,8,39,13,2451,17.94214573,1134,111,7,0.474966931
Deandre Ayton,1629028,2018-19,2183,71,125,60,44,16,39,126,24,66,60,4514,21.4356731,2483,211,18,0.481570335
Mikal Bridges,1628969,2018-19,2417,82,173,47,31,16,89,70,33,26,44,5029,12.1706399,2334,323,19,0.515295796
Ray Spalding,1629034,2018-19,148,14,5,3,3,0,1,8,4,2,6,313,16.90140845,136,6,0,0.216666667
Troy Daniels,203584,2018-19,760,51,26,7,5,2,14,27,12,13,14,1578,17.55681818,649,70,5,0.501482975
Jimmer Fredette,202690,2018-19,65,6,8,2,2,0,5,5,0,5,0,138,24.66666667,60,10,0,0.541666667
Dragan Bender,1627733,2018-19,826,46,56,26,22,4,20,37,13,15,22,1739,13.2505176,1243,99,7,0.489397779
Enes Kanter,202683,2018-19,1639,67,116,41,36,5,42,118,23,60,58,3356,22.47076767,2102,218,10,0.455060783
Damian Lillard,203081,2018-19,2838,80,551,165,120,45,296,212,113,72,140,5905,28.60495819,4288,985,66,0.859987724
Evan Turner,202323,2018-19,1606,73,283,130,111,19,113,114,65,30,84,3281,16.19379015,2827,529,13,0.796223824
CJ McCollum,203468,2018-19,2375,70,207,85,63,22,93,106,39,48,58,4934,25.18466409,2154,437,51,0.731058477
Maurice Harkless,203090,2018-19,1415,60,74,27,20,7,24,45,18,21,24,2945,13.70872642,1251,138,11,0.38591633
Rodney Hood,203918,2018-19,1893,72,126,50,40,10,53,55,17,26,29,3775,18.30398517,1628,240,9,0.58257244
Al-Farouq Aminu,202329,2018-19,2292,81,104,35,29,6,48,72,19,42,30,4744,13.63886343,2097,179,15,0.48931247
Gary Trent Jr.,1629018,2018-19,111,15,5,1,0,1,2,4,0,2,2,240,21.59090909,67,12,0,0.1
Jake Layman,1627774,2018-19,1327,71,53,26,19,7,18,46,15,24,22,2734,15.97822606,1004,108,6,0.526391363
Meyers Leonard,203086,2018-19,878,61,75,31,26,5,25,42,11,23,19,1782,15.27363184,1237,117,4,0.490380756
Skal Labissiere,1627746,2018-19,176,22,11,6,4,2,3,11,4,6,5,400,15.66820276,176,14,0,0.333333333
Anfernee Simons,1629014,2018-19,141,20,13,4,4,0,5,11,1,5,6,306,24.33234421,156,12,1,0.177156177
Jusuf Nurkic,203994,2018-19,1974,72,233,62,52,10,123,168,53,81,87,4108,24.51912915,3084,361,9,0.587972213
Seth Curry,203552,2018-19,1399,74,66,29,23,6,23,60,26,27,33,2853,16.83594952,1223,152,33,0.504145702
Zach Collins,1628380,2018-19,1356,77,71,24,21,3,33,77,18,47,30,2750,17.1162492,1617,114,2,0.494185162
Willie Cauley-Stein,1626161,2018-19,2213,81,194,70,51,19,68,83,19,44,39,4750,17.55538866,2574,324,22,0.493662084
Yogi Ferrell,1627812,2018-19,1067,71,137,56,44,12,41,40,16,16,24,2237,16.5741475,1656,268,21,0.587703121
De'Aaron Fox,1628368,2018-19,2546,81,590,220,178,42,263,227,113,71,156,5520,24.25313203,4567,1053,43,0.900392901
Bogdan Bogdanovic,203992,2018-19,1947,70,267,99,72,27,110,117,54,41,76,4092,22.582038,2632,486,39,0.667179234
BJ Johnson,1629168,2018-19,49,7,0,0,0,0,0,2,0,2,0,104,18.91891892,21,0,1,0
Frank Mason,1628412,2018-19,435,38,84,28,26,2,31,36,16,18,18,946,21.85114504,726,158,9,0.202380952
Alec Burks,202692,2018-19,1375,64,128,47,31,16,57,65,27,27,38,2780,19.11011524,1613,215,18,0.573950511
Troy Williams,1627786,2018-19,312,21,11,4,2,2,1,9,2,6,3,690,14.69072165,244,28,2,0.01010101
Harry Giles III,1628385,2018-19,820,58,85,20,14,6,46,73,25,34,39,1755,23.51447435,855,133,3,0.582805741
Buddy Hield,1627741,2018-19,2615,82,205,73,52,21,99,145,56,47,98,5623,24.81475642,2867,374,41,0.553874681
Wenyen Gabriel,1629117,2018-19,0,0,0,0,0,0,0,0,0,0,0,0,0,0,0,0,0
Corey Brewer,201147,2018-19,492,31,39,12,10,2,16,19,8,8,11,1033,13.46633416,371,67,5,0.191632928
Marvin Bagley III,1628963,2018-19,1568,62,62,22,16,6,26,98,17,58,40,3332,24.22734416,1441,110,7,0.451294732
Harrison Barnes,203084,2018-19,2533,77,115,57,47,10,44,98,33,41,57,5308,20.74396783,2598,214,17,0.517905841
Kosta Koufos,201585,2018-19,502,42,36,22,15,7,3,27,8,15,12,1057,15.59934319,660,68,3,0.451451433
Caleb Swanigan,1628403,2018-19,178,21,11,5,4,1,3,18,3,10,8,377,17.36111111,226,21,0,0.245791246
Nemanja Bjelica,202357,2018-19,1788,77,147,56,35,21,61,82,24,37,45,3831,16.62017666,2275,237,18,0.516384364
Lonnie Walker IV,1629022,2018-19,118,17,9,2,1,1,5,4,1,1,3,248,20.29520295,134,22,1,0.194444444
Quincy Pondexter,202347,2018-19,292,53,24,6,5,1,8,13,6,6,7,611,13.20754717,328,39,4,0.070512821
Derrick White,1628401,2018-19,1728,67,263,72,50,22,102,97,48,34,63,3455,18.21278826,2619,421,28,0.516151416
Dejounte Murray,1627749,2018-19,0,0,0,0,0,0,0,0,0,0,0,0,0,0,0,0,0
Chimezie Metu,1629002,2018-19,145,29,13,5,3,2,4,15,4,6,9,314,22.68907563,189,26,1,0.158974359
Patty Mills,201988,2018-19,1908,82,245,90,71,19,68,93,45,29,64,3969,18.09545352,2617,427,41,0.469132422
DeMar DeRozan,201942,2018-19,2688,77,475,196,142,54,120,199,72,66,133,5418,28.23549033,2714,794,48,0.697093271
Bryn Forbes,1627854,2018-19,2293,82,175,50,38,12,60,80,33,26,54,4610,17.60895171,2107,265,24,0.311578457
LaMarcus Aldridge,200746,2018-19,2687,81,194,71,56,15,45,144,17,84,60,5416,27.32276897,2853,312,27,0.351189118
Drew Eubanks,1629234,2018-19,113,23,7,0,0,0,2,8,2,3,5,236,15.09433962,131,8,0,-0.255952381
Marco Belinelli,201158,2018-19,1815,79,132,57,38,19,41,72,28,27,45,3757,19.37724551,1666,214,49,0.447115292
Rudy Gay,200752,2018-19,1842,69,182,57,40,17,62,114,48,37,77,3737,22.14234364,2371,291,17,0.376080102
Jakob Poeltl,1627751,2018-19,1273,77,93,33,25,8,17,48,15,26,22,2585,12.91538198,1571,174,3,0.298965773
Ben Moore,1628500,2018-19,0,0,0,0,0,0,0,0,0,0,0,0,0,0,0,0,0
Donatas Motiejunas,202700,2018-19,13,3,1,0,0,0,0,3,0,3,0,28,32.25806452,12,1,0,-0.333333333
Dante Cunningham,201967,2018-19,928,64,50,13,12,1,17,22,12,6,16,1902,8.898305085,1098,87,3,0.197227397
Davis Bertans,202722,2018-19,1632,76,100,36,22,14,32,43,17,23,20,3360,13.94722671,1921,165,18,0.378623612
Patrick McCaw,1627775,2018-19,397,29,29,20,16,4,7,17,7,6,11,816,9.592061742,374,56,7,0.382014875
Kawhi Leonard,202695,2018-19,2040,60,199,103,61,42,68,121,34,49,72,4209,30.49327354,1805,403,43,0.748433759
OG Anunoby,1628384,2018-19,1352,67,47,19,11,8,18,55,16,26,29,2824,15.26117055,1131,91,6,0.425910596
Kyle Lowry,200768,2018-19,2213,65,564,154,94,60,244,182,106,55,127,4613,19.42823804,4062,909,68,0.774275713
Jordan Loyd,1628070,2018-19,55,12,6,4,2,2,1,2,0,0,2,125,16.10738255,81,14,0,0.166666667
Serge Ibaka,201586,2018-19,2010,74,99,59,41,18,26,114,12,80,34,4124,23.15675676,2396,168,26,0.579536272
Malcolm Miller,1626259,2018-19,67,10,1,1,1,0,0,1,0,0,1,144,18.35443038,55,2,0,0.333333333
Danny Green,201980,2018-19,2215,80,126,53,36,17,48,75,34,33,42,4582,14.18509098,1981,219,27,0.491008861
Eric Moreland,203961,2018-19,43,5,4,2,2,0,1,5,4,1,4,87,12.37113402,60,5,0,0.15
Jeremy Lin,202391,2018-19,1436,74,231,84,50,34,107,123,62,33,90,3085,21.94129613,2290,421,35,0.726622337
Jodie Meeks,201975,2018-19,104,8,8,3,2,1,5,2,1,0,2,219,17.22689076,70,12,1,0.333333333
Fred VanVleet,1627832,2018-19,1760,64,307,117,70,47,97,82,41,26,56,3591,18.15468789,2745,568,42,0.665741743
Norman Powell,1626181,2018-19,1126,60,91,37,24,13,31,65,27,25,40,2359,18.94576012,1097,177,14,0.527333948
Chris Boucher,1628449,2018-19,163,28,2,1,1,0,0,7,2,4,3,353,22.24938875,178,4,1,0.023809524
Marc Gasol,201188,2018-19,2436,79,349,142,98,44,133,155,48,67,88,4840,21.47042147,4602,556,38,0.614445028
Pascal Siakam,1627783,2018-19,2548,80,248,128,70,58,77,154,47,72,82,5269,20.91793209,3385,487,39,0.650790705
Joe Ingles,204060,2018-19,2534,81,469,125,80,45,263,193,100,64,129,5312,17.53008021,3316,846,60,0.860147019
Ricky Rubio,201937,2018-19,1867,67,416,147,93,54,215,180,91,64,116,3938,22.62361707,3729,744,68,0.920061724
Dante Exum,203957,2018-19,648,41,110,40,27,13,57,52,23,19,33,1377,21.5483871,969,205,8,0.864862719
Tony Bradley,1628396,2018-19,36,3,1,1,1,0,0,3,0,3,0,79,21.05263158,42,2,0,0.666666667
Derrick Favors,202324,2018-19,1742,75,89,44,26,18,36,85,27,44,41,3630,19.57156767,2192,193,7,0.603598396
Thabo Sefolosha,200757,2018-19,596,49,27,16,13,3,11,25,7,13,12,1252,13.34776335,708,57,6,0.682812725
Royce O'Neale,1626220,2018-19,1660,81,124,59,33,26,55,70,19,39,31,3459,11.09966521,1574,270,16,0.772590544
Grayson Allen,1628960,2018-19,416,38,25,8,6,2,10,32,11,18,14,865,24.74012474,344,55,3,0.240833333
Raul Neto,203526,2018-19,474,37,93,45,28,17,37,35,19,10,25,997,19.0647482,844,178,17,0.310291859
Kyle Korver,2594,2018-19,1317,69,81,26,16,10,45,59,29,23,36,2794,17.9853829,945,131,12,0.577912874
Rudy Gobert,203497,2018-19,2544,80,161,71,53,18,55,129,27,69,60,5352,17.86069652,3644,257,23,0.465785509
Naz Mitrou-Long,1628513,2018-19,84,14,15,5,2,3,9,8,3,3,5,178,14.4278607,104,28,1,0.391666667
Georges Niang,1627777,2018-19,516,59,35,11,8,3,19,23,10,12,11,1082,17.67634855,573,56,7,0.570647605
Ekpe Udoh,202327,2018-19,320,51,28,15,9,6,7,13,2,7,6,678,13.3243607,417,44,4,0.298534799
Tyler Cavanaugh,1628463,2018-19,40,11,1,0,0,0,0,1,0,1,0,88,12.24489796,47,2,0,-0.333333333
Donovan Mitchell,1628378,2018-19,2564,76,322,161,93,68,120,218,85,85,133,5403,31.55906029,2628,646,56,0.833737945
Jae Crowder,203109,2018-19,2140,79,133,62,42,20,56,85,37,38,47,4532,18.93746324,3042,238,12,0.559023941
Trevor Ariza,2772,2018-19,2310,68,252,87,58,29,115,106,51,42,64,4897,16.75605696,2645,428,28,0.614092237
John Wall,202322,2018-19,1104,32,279,101,68,33,122,121,59,36,85,2364,29.06213817,1795,502,28,0.966165924
Bradley Beal,203078,2018-19,2988,81,448,188,134,54,191,224,84,90,134,6401,28.22524163,3834,848,79,0.818224847
Wesley Johnson,202325,2018-19,534,38,23,3,2,1,12,18,8,8,10,1132,11.86966641,402,43,3,0.321144913
Bobby Portis,1626171,2018-19,1276,49,72,17,13,4,39,74,7,39,35,2698,24.75083056,1695,138,12,0.476353186
Troy Brown Jr.,1628972,2018-19,720,51,80,23,19,4,39,30,12,7,23,1533,16.30309989,696,123,7,0.533668582
Devin Robinson,1628421,2018-19,95,7,6,3,3,0,2,2,1,0,2,196,17.77777778,92,10,1,0.166666667
Sam Dekker,1626155,2018-19,769,46,46,15,13,2,18,24,4,15,9,1626,16.33315306,778,83,0,0.473674155
Chasson Randle,1626184,2018-19,720,48,97,34,25,9,42,43,18,18,25,1549,16.6378814,1065,147,9,0.598568207
Jabari Parker,203953,2018-19,1720,63,152,65,41,24,67,151,48,73,78,3618,24.3762475,2686,307,19,0.655687012
Thomas Bryant,1628418,2018-19,1481,71,92,34,26,8,42,60,14,37,23,3143,17.55334282,1864,165,11,0.564906367
Dwight Howard,2730,2018-19,230,9,4,0,0,0,2,16,1,12,4,483,19.59334566,279,8,1,0.083333333
Tarik Phillip,1629341,2018-19,0,0,0,0,0,0,0,0,0,0,0,0,0,0,0,0,0
Ian Mahinmi,101133,2018-19,490,33,25,8,6,2,12,21,5,14,7,1017,13.25823224,559,41,4,0.355555556
Tomas Satoransky,203107,2018-19,2133,79,399,151,111,40,187,120,56,42,78,4514,14.27726287,3656,736,51,0.843484619
Jeff Green,201145,2018-19,2076,76,137,57,47,10,61,101,24,57,44,4388,17.8447749,2066,234,9,0.60874512
Jordan McRae,203895,2018-19,333,27,30,9,7,2,19,15,3,8,7,719,19.94981179,309,63,8,0.444444444
Antonius Cleveland,1628499,2017-18,123,17,2,1,1,0,1,7,2,4,3,251,11.07142857,64,10,0,0.523809524
Tyler Dorsey,1628416,2017-18,974,56,79,32,22,10,18,37,17,11,26,1985,20.00897263,992,164,12,0.399044229
Jaylen Morris,1628537,2017-18,98,6,7,2,2,0,3,6,4,2,4,208,16.03375527,66,13,0,0.158730159
Andrew White III,1628510,2017-18,209,15,6,4,2,2,1,8,2,1,7,435,16.83778234,149,15,0,0.208333333
Malcolm Delaney,1627098,2017-18,989,53,163,68,35,33,49,66,26,33,33,2034,17.11908932,1677,321,18,0.733774922
Jeremy Evans,202379,2017-18,5,1,0,0,0,0,0,1,0,1,0,12,14.28571429,6,1,0,0
Damion Lee,1627814,2017-18,404,15,29,13,12,1,11,14,4,5,9,841,18.83597884,425,72,5,0.279967159
Josh Magette,203705,2017-18,216,18,57,22,17,5,25,9,3,4,5,435,12.34309623,432,110,3,0.306042885
Taurean Prince,1627752,2017-18,2431,81,214,76,33,43,94,192,71,74,118,5028,22.11144739,2530,387,21,0.568356253
Dewayne Dedmon,203473,2017-18,1520,61,90,43,34,9,24,84,23,49,35,3126,17.07949309,1937,143,6,0.440126673
Dennis Schroder,203471,2017-18,2041,66,417,170,115,55,153,183,91,61,122,4203,30.48264183,4138,820,46,0.818951985
Miles Plumlee,203101,2017-18,918,55,45,15,11,4,10,63,13,36,27,1848,13.12108056,1050,83,5,0.248826642
John Collins,1628381,2017-18,1760,73,98,42,33,9,33,103,24,53,50,3621,17.87202746,2648,183,11,0.443246525
Isaiah Taylor,1627819,2017-18,1167,67,206,110,82,28,58,85,34,43,42,2388,20.2020202,2035,408,11,0.867600561
Kent Bazemore,203145,2017-18,1759,64,228,63,40,23,123,157,77,40,117,3602,22.73741632,2382,414,17,0.643213024
Mike Muscala,203488,2017-18,1060,53,51,28,21,7,14,42,11,20,22,2197,15.4158215,1258,83,7,0.459872533
Tyler Cavanaugh,1628463,2017-18,504,38,27,15,12,3,4,13,2,10,3,1053,14.47587354,664,60,2,0.502856358
DeAndre' Bembry,1627761,2017-18,454,25,49,17,9,8,20,47,14,20,27,911,18.75616979,544,104,3,0.230279346
Jayson Tatum,1628369,2017-18,2362,77,128,61,44,17,37,114,23,65,49,4837,19.78450678,2137,235,19,0.498476013
Jaylen Brown,1627759,2017-18,2050,67,114,40,24,16,38,124,35,56,68,4297,21.27174814,1555,210,12,0.40556875
Shane Larkin,203499,2017-18,743,51,98,37,31,6,29,33,13,8,25,1509,15.84507042,1081,177,16,0.489571501
Xavier Silas,202918,2017-18,8,2,0,0,0,0,0,0,0,0,0,15,15,6,3,0,0
Kyrie Irving,202681,2017-18,1834,57,306,127,91,36,104,139,60,43,96,3900,30.45173125,2958,581,58,0.704563191
Terry Rozier,1626179,2017-18,2001,77,232,101,76,25,71,80,30,32,48,4107,20.52060738,3416,464,44,0.575761417
Marcus Morris,202694,2017-18,1394,52,72,30,19,11,27,65,15,39,26,2881,22.8844966,1605,129,11,0.497913287
Gordon Hayward,202330,2017-18,5,1,0,0,0,0,0,0,0,0,0,11,15.38461538,7,0,0,0
Jabari Bird,1628444,2017-18,115,13,8,3,1,2,3,8,3,2,6,238,14.28571429,68,10,3,0.166666667
Daniel Theis,1628464,2017-18,894,60,56,29,24,5,15,56,17,32,24,1836,15.55343511,1083,98,1,0.509632878
Abdel Nader,1627846,2017-18,520,47,26,11,7,4,8,34,13,14,20,1063,16.69449082,408,61,5,0.468174962
Guerschon Yabusele,1627824,2017-18,233,32,16,9,6,3,5,12,4,7,5,478,14.84794275,357,31,2,0.402777778
Marcus Smart,203935,2017-18,1537,51,259,93,63,30,112,129,59,51,78,3247,19.31318681,2202,447,27,0.750445631
Semi Ojeleye,1628400,2017-18,1132,70,20,7,7,0,7,25,5,16,9,2260,9.105242412,1173,57,11,0.345613374
Al Horford,201143,2017-18,2175,69,339,146,103,43,117,131,52,61,70,4514,18.69756292,3372,555,19,0.684123989
Kadeem Allen,1628443,2017-18,107,18,12,3,1,2,6,9,5,3,6,215,13.83399209,158,21,1,0.194444444
Aron Baynes,203382,2017-18,1433,78,93,40,32,8,27,80,21,53,27,2897,17.08358755,1638,180,7,0.510097491
Greg Monroe,202328,2017-18,1024,50,114,38,30,8,55,94,29,30,64,2096,22.55067568,1334,205,7,0.609374262
Jonathan Gibson,1626780,2017-18,40,4,4,1,0,1,2,3,1,1,2,85,28.26086957,27,7,0,0.194444444
James Webb III,1627821,2017-18,120,10,4,3,1,2,1,4,2,2,2,247,10.18181818,188,6,1,0.5
D'Angelo Russell,1626156,2017-18,1234,48,249,97,78,19,122,146,61,49,97,2587,30.22530329,2195,497,24,0.953902509
Nik Stauskas,203917,2017-18,523,41,39,17,10,7,13,26,6,13,13,1056,16.39624253,563,86,5,0.586419824
Jahlil Okafor,1626143,2017-18,353,28,12,9,8,1,2,21,4,13,8,690,22.5,382,27,1,0.456349206
Jeremy Lin,202391,2017-18,25,1,4,4,4,0,0,3,2,0,3,61,26.08695652,32,7,0,0.333333333
Spencer Dinwiddie,203915,2017-18,2255,78,524,227,159,68,209,127,56,54,73,4637,20.6757535,4303,974,39,0.965409439
DeMarre Carroll,201960,2017-18,2122,71,147,68,50,18,50,102,24,49,53,4433,19.85205918,2590,298,26,0.551676609
Joe Harris,203925,2017-18,1948,77,128,55,40,15,51,91,33,45,46,4024,16.6261331,2047,274,21,0.600805003
Quincy Acy,203112,2017-18,1323,68,57,31,25,6,16,60,12,39,21,2767,14.77864583,1755,135,11,0.553525297
Milton Doyle,1628495,2017-18,125,10,10,4,4,0,6,2,1,1,1,255,18.1184669,146,26,2,0.5
Isaiah Whitehead,1627785,2017-18,163,15,20,5,4,1,13,23,8,8,15,376,27.79097387,186,40,1,0.349275362
Timofey Mozgov,202389,2017-18,346,29,11,5,3,2,2,33,0,23,10,764,16.48873072,394,24,4,0.202020202
Caris LeVert,1627747,2017-18,1802,69,299,118,86,32,131,153,64,55,98,3840,22.42100372,2449,559,29,0.824402269
Rondae Hollis-Jefferson,1626178,2017-18,1851,66,167,106,83,23,42,121,28,61,60,3938,22.26518081,2911,338,16,0.686320255
Jarrett Allen,1628386,2017-18,1401,70,49,24,18,6,16,82,21,41,41,2912,16.70229008,1700,95,9,0.440017592
Allen Crabbe,203459,2017-18,2133,73,117,43,32,11,53,78,30,34,44,4520,18.73397752,2172,245,27,0.52680626
Dante Cunningham,201967,2017-18,1562,73,48,28,22,6,17,33,11,17,16,3221,11.76966292,1596,96,8,0.564160548
Malik Monk,1628370,2017-18,854,63,91,19,14,5,40,49,24,14,35,1774,24.73551637,922,173,10,0.467134764
Marvin Williams,101107,2017-18,2006,78,96,29,25,4,38,66,27,30,36,4101,14.77469671,2801,191,14,0.346169441
Jeremy Lamb,203087,2017-18,1967,80,186,70,57,13,75,93,40,31,62,3969,22.52734985,1780,363,32,0.612491914
Marcus Paige,1627779,2017-18,28,5,3,1,0,1,1,0,0,0,0,57,22.72727273,44,7,1,0
Nicolas Batum,201587,2017-18,1981,64,349,107,96,11,150,131,79,42,89,4057,18.2457683,2497,652,32,0.766833287
Dwayne Bacon,1628407,2017-18,713,53,38,23,19,4,12,23,12,6,17,1466,13.58695652,494,78,11,0.608634138
Mangok Mathiang,1628493,2017-18,20,4,0,0,0,0,0,0,0,0,0,43,14,19,0,0,0
Michael Carter-Williams,203487,2017-18,835,52,116,44,34,10,39,52,22,24,28,1646,17.10805085,1392,258,17,0.697023592
Dwight Howard,2730,2017-18,2463,81,105,40,34,6,33,208,21,148,60,5030,24.29099877,2490,211,11,0.436157756
Michael Kidd-Gilchrist,203077,2017-18,1850,74,71,34,27,7,19,53,9,24,29,3763,16.21939736,1022,148,8,0.455569693
Kemba Walker,202689,2017-18,2736,80,444,147,114,33,171,179,89,57,122,5579,27.24088521,4518,839,81,0.648048486
Treveon Graham,1626203,2017-18,1050,63,59,21,13,8,20,27,3,21,6,2119,11.51109251,923,106,7,0.503303131
Julyan Stone,202933,2017-18,175,23,26,10,8,2,11,7,3,4,3,371,5.185185185,213,53,3,0.331501832
Cody Zeller,203469,2017-18,627,33,31,13,11,2,8,33,9,20,13,1266,15.81881533,440,57,4,0.433227436
Willy Hernangomez,1626195,2017-18,494,48,33,15,11,4,7,35,8,22,13,1011,20.86956522,641,58,3,0.20952381
Frank Kaminsky,1626163,2017-18,1835,79,129,50,34,16,45,66,22,31,35,3695,20.79422383,2827,244,21,0.445613702
Sean Kilpatrick,203930,2017-18,640,52,46,24,14,10,13,38,14,14,24,1295,24.82900137,541,80,4,0.533362484
Jerian Grant,1626170,2017-18,1686,74,342,140,106,34,106,89,44,30,59,3373,17.61288619,2999,661,32,0.777450126
Omer Asik,201600,2017-18,182,18,3,0,0,0,0,9,4,4,5,368,9.25,198,6,0,-0.518518519
Bobby Portis,1626171,2017-18,1643,73,123,58,48,10,37,103,18,54,49,3342,25.68951931,2103,209,10,0.507036504
Cristiano Felicio,1626245,2017-18,977,55,55,24,19,5,19,54,11,29,25,1964,13.632287,828,112,6,0.544066204
Justin Holiday,203200,2017-18,2265,72,153,45,34,11,60,93,36,38,55,4674,18.04193114,1483,282,24,0.470466962
Zach LaVine,203897,2017-18,656,24,72,25,17,8,28,43,12,22,21,1339,29.67180174,634,151,7,0.708340354
Antonio Blakeney,1628469,2017-18,314,19,20,9,7,2,8,11,3,5,6,632,23.48066298,171,40,0,0.334848485
David Nwaba,1628021,2017-18,1646,70,104,38,32,6,46,77,23,40,37,3321,15.63655573,990,201,11,0.639330333
Ryan Arcidiacono,1627853,2017-18,304,24,35,15,13,2,17,13,5,5,8,617,8.248914616,516,90,5,0.375824176
Paul Zipser,1627835,2017-18,824,54,46,23,11,12,13,43,9,24,19,1610,16.1200667,1239,105,11,0.514161488
Cameron Payne,1626166,2017-18,582,25,113,52,43,9,47,36,20,11,25,1189,18.80466472,1149,218,6,0.875592027
Lauri Markkanen,1628374,2017-18,2020,68,79,38,28,10,22,83,23,40,43,4108,21.96771379,3738,171,16,0.383869428
Noah Vonleh,203943,2017-18,876,54,34,14,14,0,11,31,6,19,12,1754,14.51371571,1313,83,5,0.430891398
Jarell Eddie,204067,2017-18,9,3,0,0,0,0,0,0,0,0,0,19,9.523809524,6,3,0,0
Kris Dunn,1627739,2017-18,1525,52,310,120,93,27,106,150,63,59,91,3138,24.8924577,2879,593,26,0.788303458
Robin Lopez,201577,2017-18,1690,64,124,52,45,7,37,107,22,62,45,3435,20.68604347,1420,232,12,0.544880074
Denzel Valentine,1627756,2017-18,2095,77,244,93,68,25,101,99,38,45,54,4254,17.47188671,2151,501,19,0.751986187
Kevin Love,201567,2017-18,1651,59,103,36,24,12,56,89,32,40,49,3337,25.29826464,2091,182,19,0.573625865
Rodney Hood,203918,2017-18,1616,60,95,45,22,23,36,70,20,31,39,3220,24.68229314,1333,176,23,0.574527859
George Hill,201588,2017-18,1812,67,186,74,55,19,57,88,32,43,45,3563,16.49638674,2852,391,27,0.553393635
JR Smith,2747,2017-18,2244,80,141,63,35,28,61,81,41,26,55,4537,13.88118812,1778,270,25,0.591938716
Jordan Clarkson,203903,2017-18,1887,81,221,77,63,14,108,127,41,53,74,3875,26.14720582,2073,423,22,0.737762458
Tristan Thompson,202684,2017-18,1072,53,33,11,8,3,9,36,5,24,12,2169,12.38327243,1146,73,5,0.293413002
Okaro White,1627855,2017-18,80,6,2,1,1,0,0,1,1,0,1,160,10.34482759,100,7,1,-0.166666667
Cedi Osman,1626224,2017-18,673,61,41,18,12,6,17,32,7,17,15,1368,15.48471047,643,61,6,0.549581941
Kendrick Perkins,2570,2017-18,15,1,2,0,0,0,2,1,1,0,1,28,11.76470588,19,4,0,0.333333333
Larry Nance Jr.,1626204,2017-18,1421,66,82,32,25,7,33,51,15,29,22,2909,15.93806922,1877,167,10,0.522053378
LeBron James,2544,2017-18,3026,82,747,344,214,130,285,348,153,135,213,6157,31.48773682,4674,1426,64,1.081019656
Kyle Korver,2594,2017-18,1574,73,88,20,13,7,54,54,18,30,24,3247,15.76285473,986,150,7,0.606856029
Jeff Green,201145,2017-18,1828,78,99,44,37,7,40,75,12,41,34,3713,19.47226973,1719,175,12,0.56157682
Ante Zizic,1627790,2017-18,214,32,5,2,1,1,1,11,2,6,5,441,17.82178218,185,10,2,0.115151515
Jose Calderon,101181,2017-18,914,57,117,44,31,13,55,41,24,13,28,1825,12.04637097,1492,214,27,0.662745539
Dennis Smith Jr.,1628372,2017-18,2049,69,358,175,123,52,104,194,75,70,124,4097,28.81767956,3954,741,59,0.78198284
Nerlens Noel,203457,2017-18,472,30,20,6,5,1,7,26,9,12,14,947,13.51606805,450,37,0,0.137179487
J.J. Barea,200826,2017-18,1603,69,434,127,101,26,194,143,81,40,103,3177,25.1435132,3344,764,53,0.871280026
Johnathan Motley,1628405,2017-18,176,11,7,2,2,0,3,9,1,5,4,342,24.43324937,189,13,1,0.232804233
Dwight Powell,203939,2017-18,1672,79,91,43,39,4,31,59,13,35,24,3300,15.61899533,2026,187,14,0.548402463
Kyle Collinsworth,1627858,2017-18,480,32,56,20,14,6,23,24,13,6,18,943,12.9476584,607,129,6,0.18452381
Aaron Harrison,1626151,2017-18,233,9,11,7,6,1,2,3,1,2,1,467,15.18026565,176,25,0,0.373737374
Dorian Finney-Smith,1627827,2017-18,448,21,26,14,9,5,6,21,10,9,12,888,14.79642502,411,53,1,0.245421245
Yogi Ferrell,1627812,2017-18,2282,82,201,90,65,25,58,78,39,31,47,4500,17.14572864,2797,408,43,0.526791484
Doug McDermott,203926,2017-18,1736,80,79,31,24,7,22,56,13,32,24,3563,14.85173187,1476,145,12,0.376459428
Jalen Jones,1627883,2017-18,181,16,4,2,1,1,2,7,1,5,2,357,19.80906921,152,14,2,0.571428571
Wesley Matthews,202083,2017-18,2131,63,172,85,69,16,57,83,40,25,58,4214,17.81236489,2037,334,24,0.58001688
Seth Curry,203552,2017-18,0,0,0,0,0,0,0,0,0,0,0,0,0,0,0,0,0
Harrison Barnes,203084,2017-18,2634,77,152,87,64,23,38,118,41,42,76,5225,25.37417334,3013,288,24,0.479271025
Dirk Nowitzki,1717,2017-18,1900,77,120,43,28,15,48,51,17,20,31,3793,20.66115702,2385,183,13,0.39543097
Maxi Kleber,1628467,2017-18,1206,72,51,31,26,5,8,30,16,9,21,2379,13.82575758,1054,86,5,0.35094326
Salah Mejri,1626257,2017-18,729,61,35,19,16,3,5,38,6,23,15,1416,12.94191919,833,63,2,0.38285201
Darrell Arthur,201589,2017-18,141,19,9,5,5,0,4,15,1,11,4,294,20,160,16,1,0.577777778
Torrey Craig,1628470,2017-18,629,39,25,9,8,1,10,20,6,8,12,1235,12.5,461,39,5,0.373268545
Paul Millsap,200794,2017-18,1143,38,105,50,39,11,36,73,18,37,36,2282,22.30354391,1234,168,9,0.604454977
Will Barton,203115,2017-18,2683,81,331,120,94,26,151,149,46,67,82,5398,20.65605716,3335,626,34,0.722979651
Trey Lyles,1626168,2017-18,1391,73,91,39,35,4,37,61,25,21,40,2785,21.29337539,1850,169,13,0.496098945
Monte Morris,1628420,2017-18,25,3,7,1,1,0,4,1,1,0,1,53,14.03508772,52,13,0,0.047619048
Gary Harris,203914,2017-18,2305,67,194,81,67,14,77,119,43,49,70,4630,20.88414634,1646,323,33,0.62138467
Nikola Jokic,203999,2017-18,2443,75,458,146,116,30,221,208,66,102,106,4872,24.30293218,4975,703,40,0.727172398
Tyler Lydon,1628399,2017-18,2,1,0,0,0,0,0,0,0,0,0,4,0,4,1,0,0
Wilson Chandler,201163,2017-18,2346,74,159,83,50,33,47,92,28,36,56,4689,14.51098179,1997,305,21,0.564115798
Richard Jefferson,2210,2017-18,163,20,15,9,6,3,6,5,3,2,3,330,9.333333333,136,30,0,0.466666667
Mason Plumlee,203486,2017-18,1439,74,142,52,36,16,69,101,35,45,56,2881,16.68700427,1725,243,16,0.643697695
Malik Beasley,1627736,2017-18,583,62,31,17,13,4,13,24,10,10,14,1200,15.7779401,344,50,2,0.671076288
Jamal Murray,1627750,2017-18,2565,81,274,105,88,17,91,172,67,64,108,5118,22.96923609,4288,557,64,0.519744192
Devin Harris,2734,2017-18,1340,71,152,53,41,12,63,76,39,28,48,2690,20.24250589,1713,269,11,0.577078957
Kenneth Faried,202702,2017-18,461,32,18,6,5,1,7,23,5,15,8,916,17.92279412,442,36,2,0.27294686
Juancho Hernangomez,1627823,2017-18,277,25,12,7,3,4,4,9,2,5,4,557,13.77708978,260,22,2,0.435185185
Andre Drummond,203083,2017-18,2625,78,237,52,40,12,94,199,59,97,102,5258,21.05878424,2724,434,5,0.436504007
Reggie Jackson,202704,2017-18,1201,45,238,106,74,32,88,99,41,32,67,2371,27.05795496,2216,474,23,0.864773516
Luke Kennard,1628379,2017-18,1463,73,124,56,38,18,45,69,24,26,43,2883,17.43573862,1058,230,15,0.648055841
Stanley Johnson,1626169,2017-18,1894,69,112,53,38,15,48,77,32,31,46,3768,16.54135338,1203,246,12,0.703690804
Henry Ellenson,1627740,2017-18,329,38,20,14,11,3,4,18,9,7,11,666,23.95128552,553,39,1,0.362962963
Langston Galloway,204038,2017-18,863,58,58,28,23,5,19,18,6,8,10,1711,19.44734098,780,116,11,0.57495909
Ish Smith,202397,2017-18,2043,82,360,189,140,49,116,107,42,39,68,4098,20.78541983,3995,752,50,0.858372325
Dwight Buycks,202779,2017-18,427,29,59,26,17,9,16,39,22,12,27,837,27.51605996,705,118,12,0.147761843
Kay Felder,1627770,2017-18,140,16,20,7,4,3,9,16,10,5,11,285,28.93081761,225,41,5,0.2375
Blake Griffin,201933,2017-18,1970,58,334,141,111,30,114,165,65,69,96,3970,29.01577427,3522,592,23,0.704794255
Eric Moreland,203961,2017-18,805,67,78,30,26,4,21,41,15,22,19,1549,10.06904488,876,145,6,0.511690614
Reggie Bullock,203493,2017-18,1732,62,95,39,27,12,35,47,18,18,29,3488,15.60517635,1219,155,15,0.456585598
Jon Leuer,202720,2017-18,136,8,5,0,0,0,2,7,1,5,2,288,15.75562701,176,11,2,-0.028571429
James Ennis III,203516,2017-18,1604,72,71,20,13,7,35,56,24,25,31,3132,13.8700565,1027,143,14,0.48518337
Reggie Hearn,203687,2017-18,7,3,0,0,0,0,0,0,0,0,0,13,11.11111111,1,0,0,0
Jameer Nelson,2749,2017-18,1013,50,179,75,54,21,66,67,35,21,46,2047,14.2412105,2064,336,28,0.719999195
Anthony Tolliver,201229,2017-18,1757,79,90,25,18,7,39,58,24,24,34,3485,14.88764045,3010,180,9,0.344623497
Patrick McCaw,1627775,2017-18,961,57,81,32,25,7,23,41,14,17,24,1956,12.89728236,1173,148,14,0.430735513
JaVale McGee,201580,2017-18,615,65,33,11,9,2,9,27,9,13,14,1282,18.85995778,613,50,3,0.262754648
Jordan Bell,1628395,2017-18,809,57,102,26,24,2,40,51,22,21,30,1661,13.93442623,1284,169,9,0.458166873
David West,2561,2017-18,999,73,138,31,21,10,64,80,30,42,38,1960,22.80945758,1403,251,12,0.626892734
Quinn Cook,1626188,2017-18,741,33,89,29,24,5,28,32,13,13,19,1489,18.07598039,1283,157,21,0.443444728
Kevon Looney,1626172,2017-18,910,66,42,16,13,3,15,31,8,15,16,1854,12.54237288,1108,89,6,0.410846002
Nick Young,201156,2017-18,1393,80,36,15,11,4,9,39,15,17,22,2868,17.5,961,76,8,0.278941939
Andre Iguodala,2738,2017-18,1622,64,210,65,54,11,81,67,26,25,42,3321,11.62472648,2307,365,34,0.536194495
Klay Thompson,202691,2017-18,2504,73,185,42,30,12,105,128,53,51,77,5167,23.79523389,2028,315,46,0.541864594
Damian Jones,1627745,2017-18,89,15,2,0,0,0,2,4,0,3,1,177,14.89361702,74,7,0,0.583333333
Draymond Green,203110,2017-18,2287,70,508,149,116,33,203,202,102,81,121,4752,17.33513305,4463,857,53,0.726660104
Zaza Pachulia,2585,2017-18,972,69,109,46,39,7,34,72,27,37,35,2013,16.93620845,1418,184,26,0.557635221
Stephen Curry,201939,2017-18,1631,51,310,93,72,21,152,153,74,55,98,3507,29.67977089,2665,535,73,0.772251711
Shaun Livingston,2733,2017-18,1129,71,140,43,35,8,47,58,22,29,29,2265,17.11857548,1843,252,28,0.502797107
Kevin Durant,201142,2017-18,2325,68,366,131,104,27,166,207,88,78,129,4862,29.99062793,2854,614,49,0.74963528
Trevor Ariza,2772,2017-18,2269,67,105,59,29,30,39,52,14,27,25,4596,14.34689507,1740,216,17,0.659077642
RJ Hunter,1626154,2017-18,45,5,3,1,0,1,2,2,1,1,1,90,21.78217822,37,8,1,0.5
Chris Paul,101108,2017-18,1847,58,457,264,195,69,163,128,54,45,83,3688,24.90215264,2926,895,35,1.175323224
PJ Tucker,200782,2017-18,2281,82,77,36,25,11,36,74,24,44,30,4589,10.55912722,2059,193,14,0.644943302
Aaron Jackson,1628935,2017-18,35,1,1,1,0,1,0,1,0,1,0,65,15.27777778,49,9,0,0.666666667
Joe Johnson,2207,2017-18,1205,55,83,44,24,20,32,49,14,15,34,2402,16.16314199,1411,199,10,0.657216756
Zhou Qi,1627753,2017-18,124,18,2,1,0,1,1,10,1,5,5,262,16.38225256,101,10,0,0.5
Eric Gordon,201569,2017-18,2154,69,154,76,38,38,64,130,37,59,71,4390,24.36444987,1483,281,14,0.713642043
Luc Mbah a Moute,201601,2017-18,1564,61,55,29,15,14,20,68,18,38,30,3140,13.15028902,1116,107,6,0.574809392
James Harden,201935,2017-18,2551,72,630,241,165,76,359,314,149,100,214,5133,35.98040931,3685,1177,56,1.172662074
Gerald Green,101123,2017-18,929,41,25,12,8,4,11,31,8,15,16,1886,22.5060241,687,63,4,0.574141567
Clint Capela,203991,2017-18,2034,74,68,38,19,19,25,102,21,56,46,4057,19.48222905,2842,171,14,0.587050149
Chinanu Onuaku,1627778,2017-18,22,1,1,0,0,0,1,3,1,2,1,39,18.60465116,18,2,0,0.555555556
Markel Brown,203900,2017-18,31,4,2,0,0,0,2,2,2,0,2,62,13.63636364,33,3,0,0.333333333
Tarik Black,204028,2017-18,537,51,13,6,5,1,4,35,9,22,13,1106,15.17352704,746,50,1,0.47222191
Ryan Anderson,201583,2017-18,1725,66,60,35,27,8,22,42,8,20,22,3502,14.41717791,1450,126,5,0.602003522
Nene ,2403,2017-18,758,52,45,28,20,8,16,40,11,23,17,1568,18.85913853,898,98,9,0.74119678
Alex Poythress,1627816,2017-18,104,25,2,1,1,0,0,2,1,1,1,205,11.76470588,95,4,1,2.78E-17
Lance Stephenson,202362,2017-18,1850,82,235,51,37,14,110,131,66,48,83,3647,21.6457529,2014,447,13,0.604145118
Darren Collison,201954,2017-18,2018,69,368,111,88,23,118,86,36,36,50,4031,17.47767857,3421,700,34,0.646647455
Joe Young,1626202,2017-18,558,53,39,13,7,6,16,26,6,12,14,1109,17.76367962,633,87,6,0.524123968
Victor Oladipo,203506,2017-18,2552,75,323,105,72,33,140,220,68,88,132,5126,30.10320098,2914,661,32,0.711029102
Edmond Sumner,1628410,2017-18,2,1,0,0,0,0,0,0,0,0,0,4,25,2,0,0,0
Cory Joseph,202709,2017-18,2210,82,260,90,67,23,84,87,40,31,56,4366,14.76401775,3339,526,44,0.516879294
Domantas Sabonis,1627734,2017-18,1810,74,151,69,49,20,37,137,29,80,57,3587,22.01722017,3120,291,17,0.484010002
Ike Anigbogu,1628387,2017-18,30,11,0,0,0,0,0,2,1,0,2,64,18.42105263,44,0,0,0
Trevor Booker,202344,2017-18,1148,67,82,46,37,9,18,59,11,34,25,2360,16.48638568,1799,166,5,0.542784322
Thaddeus Young,201152,2017-18,2607,81,152,63,38,25,59,103,43,40,63,5154,17.49089016,2840,279,15,0.47067375
TJ Leaf,1628388,2017-18,459,53,9,4,3,1,1,11,7,3,8,928,14.39322672,460,28,1,-0.02020202
Al Jefferson,2744,2017-18,484,36,30,8,4,4,9,21,7,9,12,955,22.67168391,709,59,5,0.042857143
Ben Moore,1628500,2017-18,9,2,1,0,0,0,1,0,0,0,0,20,0,8,1,0,0
Myles Turner,1626167,2017-18,1836,65,87,38,20,18,34,96,21,61,35,3661,20.29411765,2322,156,8,0.524875879
Glenn Robinson III,203922,2017-18,338,23,17,3,3,0,8,5,0,4,1,668,12.38591917,272,24,5,0.247058824
Bojan Bogdanovic,202711,2017-18,2465,80,119,40,27,13,47,106,35,46,60,4917,19.00675552,1772,215,15,0.417632782
Sindarius Thornwell,1628414,2017-18,1156,73,68,13,11,2,43,53,19,23,30,2340,12.25416036,937,133,7,0.558511106
Jawun Evans,1628393,2017-18,778,48,100,24,16,8,56,44,24,11,33,1611,17.65356945,1182,186,14,0.613101623
Milos Teodosic,1628462,2017-18,1134,45,209,61,45,16,117,97,48,36,61,2364,18.23372668,2189,396,17,0.838830187
Montrezl Harrell,1626149,2017-18,1293,76,74,22,16,6,30,68,20,26,42,2656,23.61389446,1337,113,9,0.335398251
DeAndre Jordan,201599,2017-18,2423,77,117,36,26,10,46,137,47,69,68,4896,15.30758226,3352,202,13,0.345701502
Sam Dekker,1626155,2017-18,883,73,38,8,5,3,23,33,13,17,16,1815,15.47851563,999,76,7,0.48298627
Danilo Gallinari,201568,2017-18,671,21,41,12,7,5,21,26,10,12,14,1337,21.04918033,723,75,8,0.507565448
C.J. Williams,203710,2017-18,707,38,43,11,8,3,20,20,4,13,7,1433,13.78676471,543,64,5,0.479317291
Avery Bradley,202340,2017-18,1433,46,94,38,29,9,38,101,38,45,56,2867,23.3241506,1046,172,18,0.574822683
Tyrone Wallace,1627820,2017-18,851,30,71,17,11,6,41,46,17,15,31,1786,16.38530288,955,119,15,0.523373211
Patrick Beverley,201976,2017-18,334,11,32,9,6,3,12,25,14,9,16,648,20.07926024,528,78,11,0.109583333
Lou Williams,101150,2017-18,2589,79,417,95,61,34,264,234,139,64,170,5404,29.11413132,3149,676,56,0.761188693
Austin Rivers,203085,2017-18,2057,61,242,103,77,26,97,109,35,45,64,4109,20.99871959,3112,441,35,0.653493693
Wesley Johnson,202325,2017-18,1486,74,61,25,19,6,31,53,25,23,30,3053,13.00931315,1063,96,9,0.550933611
Tobias Harris,202699,2017-18,2668,80,192,89,59,30,76,105,34,51,54,5383,23.14117262,4100,353,31,0.573019502
Boban Marjanovic,1626246,2017-18,338,39,22,3,2,1,13,36,4,23,13,697,28.75157629,284,34,2,0.273569024
Kyle Kuzma,1628398,2017-18,2401,77,141,49,36,13,79,139,32,75,64,4960,22.47510669,2352,276,16,0.653289909
Kentavious Caldwell-Pope,203484,2017-18,2458,74,162,54,43,11,83,97,32,42,55,5098,16.84338606,2118,321,23,0.605494295
Lonzo Ball,1628366,2017-18,1780,52,376,118,88,30,180,136,68,53,83,3753,17.24952741,3403,685,28,0.841912923
Isaiah Thomas,202738,2017-18,862,32,153,54,37,17,77,95,34,37,58,1820,28.26193993,1185,287,21,0.894507774
Alex Caruso,1627936,2017-18,562,37,75,25,21,4,40,42,21,13,29,1157,13.3126935,891,164,11,0.779052401
Josh Hart,1628404,2017-18,1461,63,80,36,29,7,32,47,25,15,32,2974,13.76554174,1031,148,15,0.534566743
Luol Deng,2736,2017-18,13,1,1,0,0,0,0,1,0,1,0,29,9.090909091,9,2,0,-0.333333333
Tyler Ennis,203898,2017-18,683,54,105,39,29,10,39,37,19,14,23,1399,17.46335245,1193,204,19,0.671996372
Brook Lopez,201572,2017-18,1735,74,126,36,27,9,55,98,27,55,43,3627,23.49471615,1762,218,13,0.492001842
Channing Frye,101112,2017-18,695,53,38,20,15,5,16,21,7,11,10,1418,15.46391753,907,85,6,0.671322633
Brandon Ingram,1627742,2017-18,1975,59,230,99,75,24,97,150,49,58,92,4098,22.17940484,2154,482,34,0.782216499
Andre Ingram,201281,2017-18,64,2,7,4,3,1,1,3,1,2,1,141,13.90728477,46,9,0,0.26984127
Travis Wear,204037,2017-18,228,17,7,5,5,0,1,6,3,1,5,457,16.17357002,247,18,3,0.246031746
Gary Payton II,1627780,2017-18,221,23,21,9,7,2,5,7,2,5,2,447,16.6015625,253,40,1,0.238095238
Julius Randle,203944,2017-18,2190,82,210,99,77,22,76,213,42,114,99,4511,25.65063091,2796,399,29,0.669966066
Thomas Bryant,1628418,2017-18,72,15,6,2,1,1,3,2,0,2,0,151,16.26506024,79,8,1,0.5
Ivica Zubac,1627826,2017-18,410,43,25,8,8,0,7,26,7,8,18,844,17.87941788,559,35,2,0.035897436
JaMychal Green,203210,2017-18,1542,55,79,22,18,4,36,76,25,38,38,2988,18.21958457,1865,151,9,0.413067136
Jarell Martin,1626185,2017-18,1661,73,73,27,20,7,26,86,30,33,53,3261,17.31919521,1941,145,7,0.349268277
Kobi Simmons,1628424,2017-18,643,32,68,25,18,7,25,44,20,21,23,1273,16.90921691,1008,134,8,0.569053002
Briante Weber,1627362,2017-18,237,18,22,12,9,3,7,15,8,4,11,485,11.47540984,413,66,1,0.285858586
Myke Henry,1627988,2017-18,378,20,22,7,4,3,7,19,11,5,14,761,15.22491349,380,49,5,0.057416268
Andrew Harrison,1626150,2017-18,1326,56,177,61,47,14,57,81,41,32,49,2542,20.18156425,2339,390,40,0.592542812
Mario Chalmers,201596,2017-18,1421,66,197,60,52,8,102,117,46,52,65,2868,19.22600619,2650,378,29,0.712467869
Wayne Selden,1627782,2017-18,691,35,66,15,11,4,33,54,22,22,32,1401,22.24346718,637,122,11,0.564487009
MarShon Brooks,202705,2017-18,193,7,25,9,3,6,11,16,6,8,8,384,28.22222222,225,58,2,0.3
Ivan Rabb,1628397,2017-18,516,36,32,7,6,1,16,35,16,8,27,1025,17.23259762,666,59,5,0.331203483
Mike Conley,201144,2017-18,373,12,49,22,16,6,17,18,10,2,16,720,26.86945501,572,113,7,0.166288738
Tyreke Evans,201936,2017-18,1607,52,269,92,69,23,124,117,54,47,70,3127,28.56739192,2639,545,46,0.815869322
Marquis Teague,203104,2017-18,74,3,13,5,5,0,1,3,1,2,1,148,12.5748503,139,17,0,0.017094017
Deyonta Davis,1627738,2017-18,943,62,40,20,18,2,10,32,7,19,13,1879,15.19285042,1043,78,1,0.438749016
Ben McLemore,203463,2017-18,1091,56,51,17,14,3,15,61,28,24,37,2159,18.76523152,1061,100,12,0.27784159
Dillon Brooks,1628415,2017-18,2350,82,135,43,32,11,50,124,46,62,62,4580,18.84510339,2150,301,33,0.456973995
Chandler Parsons,202718,2017-18,691,36,69,22,19,3,33,35,10,18,17,1370,18.61702128,776,127,11,0.649314754
Marc Gasol,201188,2017-18,2408,73,305,131,98,33,126,194,53,95,99,4677,26.09360076,4588,565,30,0.696968417
Josh Richardson,1626196,2017-18,2657,80,231,88,62,26,96,140,55,56,84,5307,18.17114094,3333,472,33,0.582461584
Wayne Ellington,201961,2017-18,2018,76,79,30,18,12,36,52,21,22,30,3991,17.33183857,1445,186,14,0.530692201
Dwyane Wade,2548,2017-18,1536,67,228,84,60,24,110,140,63,50,90,3138,25.7981756,2179,460,23,0.813843324
Derrick Jones Jr.,1627884,2017-18,245,20,9,4,1,3,3,7,4,3,4,483,12.70125224,143,18,1,0.253968254
Goran Dragic,201609,2017-18,2349,74,359,127,75,52,155,166,62,75,91,4746,25.44534033,4267,744,64,0.760542965
Tyler Johnson,204020,2017-18,2025,71,165,80,56,24,59,81,39,30,51,4067,18.5347664,2040,348,33,0.641654453
Kelly Olynyk,203482,2017-18,1751,75,207,105,72,33,72,147,42,73,74,3503,22.0709147,2848,395,18,0.718217877
Dion Waiters,203079,2017-18,893,29,113,58,39,19,40,70,29,26,44,1813,25.54780876,1049,219,14,0.778410513
Bam Adebayo,1628389,2017-18,1348,68,101,58,44,14,19,66,10,38,28,2637,16.34097035,1331,228,5,0.628068003
Derrick Walton Jr.,1628476,2017-18,147,16,16,7,6,1,4,2,1,1,1,285,9.677419355,225,40,1,0.1875
James Johnson,201949,2017-18,1912,72,280,146,109,37,101,141,44,70,71,3854,19.05756732,2925,550,14,0.856651916
Rodney McGruder,203585,2017-18,299,18,17,8,6,2,6,3,0,2,1,588,11.816839,259,45,4,0.379084967
Justise Winslow,1626159,2017-18,1655,67,148,55,37,18,66,77,31,32,45,3317,16.37144391,2461,313,13,0.605736978
Hassan Whiteside,202355,2017-18,1364,54,54,22,20,2,14,92,21,43,49,2730,23.97679665,1015,106,2,0.337943209
Luke Babbitt,202337,2017-18,690,49,31,18,11,7,7,19,7,12,7,1451,15.2173913,816,52,6,0.489399071
Jordan Mickey,1626175,2017-18,284,23,9,4,4,0,1,18,5,12,6,551,17.47572816,420,22,0,0.111111111
Udonis Haslem,2617,2017-18,72,14,5,2,2,0,1,2,0,1,1,136,11.68831169,50,10,0,0.1
Xavier Munford,204098,2017-18,21,6,4,1,1,0,1,2,0,1,1,42,18.75,34,4,0,2.78E-17
Jason Terry,1891,2017-18,814,51,59,18,11,7,26,25,13,10,15,1631,10.03861004,760,104,3,0.477035612
D.J. Wilson,1628391,2017-18,71,22,3,0,0,0,2,4,1,2,2,144,13.37579618,86,9,0,0.166666667
Eric Bledsoe,202339,2017-18,2322,74,370,100,64,36,183,218,90,90,128,4680,25.93092803,3786,694,53,0.718000073
Thon Maker,1627748,2017-18,1224,73,46,12,8,4,28,44,16,20,24,2428,15.1014275,1216,67,11,0.464250949
Matthew Dellavedova,203521,2017-18,691,37,145,41,28,13,77,49,28,17,32,1394,13.79763469,1182,261,17,0.861298337
Brandon Jennings,201943,2017-18,205,14,44,5,3,2,24,18,10,7,11,420,19.62025316,407,73,2,0.122053872
Jabari Parker,203953,2017-18,743,31,59,15,11,4,30,45,12,21,24,1504,23.57771261,975,121,6,0.538556615
Malcolm Brogdon,1627763,2017-18,1400,47,152,44,33,11,61,66,28,28,38,2844,19.30329179,1963,290,18,0.520412867
Shabazz Muhammad,203498,2017-18,418,43,14,6,6,0,4,6,0,4,2,835,23.1511254,221,19,2,0.26984127
Tony Snell,203503,2017-18,2028,74,98,34,27,7,36,36,16,14,22,4104,10.72142064,1403,153,19,0.361744496
Khris Middleton,203114,2017-18,2947,81,328,102,64,38,174,191,77,74,117,5983,24.28289574,3499,612,25,0.686517532
Sterling Brown,1628425,2017-18,776,54,25,14,9,5,8,25,7,11,14,1533,13.93869289,610,69,8,0.56203228
John Henson,203089,2017-18,1953,75,114,33,22,11,45,84,19,57,27,3912,15.15570934,1603,172,9,0.439102787
Giannis Antetokounmpo,203507,2017-18,2715,74,361,172,113,59,122,223,48,117,106,5489,31.39419908,4246,689,59,0.738671352
Marshall Plumlee,1627850,2017-18,52,8,2,1,0,1,0,3,0,1,2,108,11.66666667,44,6,0,-0.055555556
Tyler Zeller,203092,2017-18,1066,64,47,24,19,5,14,47,7,26,21,2266,16.10764431,986,75,2,0.472662516
Jeff Teague,201952,2017-18,2311,70,492,117,77,40,212,177,92,50,127,4654,20.42867982,4022,847,36,0.673294229
Tyus Jones,1626145,2017-18,1467,82,232,81,55,26,82,59,24,27,32,2884,12.93394777,2611,414,24,0.629230441
Anthony Brown,1626148,2017-18,4,1,1,0,0,0,1,0,0,0,0,9,11.11111111,4,1,0,0
Gorgui Dieng,203476,2017-18,1333,79,71,33,26,7,22,59,11,37,22,2668,16.52754591,1703,146,14,0.512279213
Nemanja Bjelica,202357,2017-18,1371,67,86,23,13,10,35,52,14,22,30,2768,14.32720232,1666,162,12,0.3641784
Amile Jefferson,1628518,2017-18,0,0,0,0,0,0,0,0,0,0,0,0,0,0,0,0,0
Jamal Crawford,2037,2017-18,1653,80,185,38,32,6,102,95,45,36,59,3298,23.83799946,1412,317,20,0.632682664
Marcus Georges-Hunt,1627875,2017-18,224,42,7,4,2,2,2,3,0,2,1,456,11.77606178,103,16,0,0.412698413
Andrew Wiggins,203952,2017-18,2979,82,160,61,38,23,56,138,38,54,84,5959,23.28362616,1814,306,35,0.466425132
Jimmy Butler,202710,2017-18,2164,59,288,74,52,22,118,109,43,48,61,4252,25.01554404,2395,544,24,0.625315187
Justin Patton,1628383,2017-18,4,1,0,0,0,0,0,0,0,0,0,9,22.22222222,2,0,0,0
Derrick Rose,201565,2017-18,419,25,37,13,8,5,14,35,9,13,22,877,25.10330579,460,58,9,0.186872587
Aaron Brooks,201166,2017-18,189,32,20,8,7,1,4,11,5,5,6,382,19.90632319,287,43,1,0.084848485
Karl-Anthony Towns,1626157,2017-18,2918,82,199,58,40,18,81,159,29,103,56,5760,22.9969419,4102,350,24,0.45302811
Cole Aldrich,202332,2017-18,49,21,3,1,0,1,1,1,0,1,0,108,15.2,59,3,0,0.333333333
Taj Gibson,201959,2017-18,2726,82,99,39,30,9,35,89,16,43,46,5423,14.72931231,3104,206,12,0.383791348
DeMarcus Cousins,202326,2017-18,1737,48,257,84,42,42,111,243,77,113,130,3565,32.53503185,2877,446,21,0.658882185
Larry Drew II,203580,2017-18,70,10,10,3,1,2,4,3,2,1,2,139,17.41935484,105,19,0,0.144444444
Ian Clark,203546,2017-18,1454,74,110,35,29,6,55,57,27,21,36,3005,17.30187538,1316,195,16,0.556611253
Nikola Mirotic,202703,2017-18,1494,55,80,21,17,4,35,62,22,26,36,3121,23.03949628,2227,148,6,0.338638315
Charles Cooke,1628429,2017-18,38,13,1,1,1,0,0,1,0,1,0,83,16.49484536,23,1,0,0.666666667
Rajon Rondo,200765,2017-18,1705,65,533,143,108,35,248,150,74,66,84,3602,16.69176707,3669,884,37,0.972996148
Jrue Holiday,201950,2017-18,2927,81,486,168,119,49,208,213,99,79,134,6133,22.9428276,4439,898,60,0.739723143
Cheick Diallo,1627767,2017-18,581,52,19,7,6,1,7,28,5,18,10,1202,17.35228123,656,28,0,0.375336851
Frank Jackson,1628402,2017-18,0,0,0,0,0,0,0,0,0,0,0,0,0,0,0,0,0
Darius Miller,203121,2017-18,1944,82,111,39,28,11,46,58,25,20,38,4023,12.77364026,1297,203,10,0.474980531
Anthony Davis,203076,2017-18,2727,75,174,75,52,23,59,162,32,78,84,5723,29.73229843,3352,298,22,0.462121845
Jordan Crawford,202348,2017-18,53,5,13,7,5,2,4,5,0,2,3,116,24.06015038,97,20,1,0.312820513
DeAndre Liggins,202732,2017-18,708,57,48,18,13,5,20,20,9,8,12,1436,8.15806246,547,101,6,0.585632211
Alexis Ajinca,201582,2017-18,0,0,0,0,0,0,0,0,0,0,0,0,0,0,0,0,0
Solomon Hill,203524,2017-18,187,12,22,9,5,4,7,9,2,6,3,407,11.67400881,186,31,1,0.282828283
Emeka Okafor,2731,2017-18,353,26,8,6,6,0,0,13,3,8,5,758,13.6682243,262,15,1,0.288461538
E'Twaun Moore,202734,2017-18,2586,82,187,56,40,16,80,102,31,44,58,5413,16.13498993,2151,348,28,0.500752892
Enes Kanter,202683,2017-18,1807,70,105,31,29,2,30,121,26,64,57,3662,21.604354,2643,199,14,0.276014764
Troy Williams,1627786,2017-18,307,21,16,5,4,1,5,19,10,8,11,638,19.41747573,266,26,3,0.098684211
Emmanuel Mudiay,1626144,2017-18,1244,64,206,73,50,23,81,113,45,52,61,2555,23.76712329,2115,378,20,0.716880404
Luke Kornet,1628436,2017-18,326,20,26,8,8,0,11,12,5,2,10,667,19.23601637,507,46,1,0.11965812
Tim Hardaway Jr.,203501,2017-18,1885,57,155,57,38,19,52,92,38,36,56,3826,23.41931066,1958,306,16,0.48561006
Isaiah Hicks,1628439,2017-18,239,18,16,10,8,2,1,16,4,10,6,484,18.23308271,241,30,1,0.229166667
Courtney Lee,201584,2017-18,2278,75,180,53,44,9,68,84,37,34,50,4624,16.91134414,1942,358,24,0.481977625
Kristaps Porzingis,204001,2017-18,1553,48,57,26,20,6,14,92,12,48,44,3102,31.08031674,1780,129,12,0.364537708
Michael Beasley,201563,2017-18,1616,73,123,39,23,16,52,143,48,53,90,3335,26.69123454,2000,250,22,0.476416826
Kyle O'Quinn,203124,2017-18,1362,76,158,24,19,5,95,100,30,62,38,2762,17.42081448,2346,283,5,0.621578091
Frank Ntilikina,1628373,2017-18,1693,77,250,83,70,13,100,131,80,31,100,3404,17.16359865,2931,492,43,0.602682926
Joakim Noah,201149,2017-18,40,7,4,2,2,0,1,4,1,3,1,84,17.0212766,77,14,0,0.333333333
Damyean Dotson,1628422,2017-18,474,44,31,10,9,1,16,17,8,6,11,958,17.36694678,418,62,4,0.28969007
Trey Burke,203504,2017-18,785,36,170,54,37,17,77,43,17,19,24,1581,25.38071066,1486,304,20,0.84304558
Ron Baker,1627758,2017-18,367,28,47,10,8,2,27,18,9,7,11,768,10.41666667,426,79,4,0.250197006
Lance Thomas,202498,2017-18,1328,72,44,15,10,5,12,41,11,23,18,2683,10.97199341,1229,102,3,0.2937631
Jarrett Jack,101127,2017-18,1513,61,348,98,64,34,142,115,53,35,80,3100,16.78977273,3111,620,38,0.733512503
Russell Westbrook,201566,2017-18,2843,78,820,310,224,86,371,382,193,119,263,5946,33.21814255,4857,1587,81,1.152618639
Raymond Felton,101109,2017-18,1335,80,203,87,59,28,84,76,32,25,51,2628,21.77283451,2090,398,21,0.773904951
Corey Brewer,201147,2017-18,1209,72,65,21,18,3,33,49,20,23,26,2528,14.1025641,743,131,2,0.605231408
Nick Collison,2555,2017-18,58,13,4,1,1,0,1,7,0,7,0,152,18.71345029,100,7,0,0.166666667
Carmelo Anthony,2546,2017-18,2432,76,103,56,35,21,33,98,23,57,41,5068,22.6798924,2737,170,11,0.523301671
Alex Abrines,203518,2017-18,1100,73,28,10,7,3,11,25,10,8,17,2256,12.97297297,726,72,5,0.354628099
Jerami Grant,203924,2017-18,1625,80,57,39,26,13,13,54,11,23,31,3263,16.6711846,1797,144,5,0.556338284
Steven Adams,203500,2017-18,2457,75,88,37,26,11,32,128,19,78,50,5032,16.27398182,2014,212,14,0.512096487
Paul George,202331,2017-18,2854,78,263,100,60,40,112,212,82,90,122,5867,25.41697417,2554,507,34,0.657083965
Kyle Singler,202713,2017-18,36,11,2,2,1,1,0,3,0,1,2,119,22.22222222,33,5,0,0.444444444
Andre Roberson,203460,2017-18,983,37,46,15,10,5,19,30,8,18,12,2025,8.753647353,709,72,9,0.447260417
Terrance Ferguson,1628390,2017-18,742,59,19,8,5,3,7,11,2,8,3,1509,10.59564719,293,48,4,0.593743813
Daniel Hamilton,1627772,2017-18,28,6,8,1,1,0,5,2,0,2,0,55,20.96774194,49,13,0,0.416666667
Josh Huestis,203962,2017-18,968,68,20,12,9,3,5,26,12,9,17,1917,9.805693629,646,35,5,0.38905454
PJ Dozier,1628408,2017-18,3,2,0,0,0,0,0,1,0,1,0,6,42.85714286,2,0,0,0
Dakari Johnson,1626177,2017-18,148,30,8,5,3,2,2,3,0,3,0,319,14.24657534,128,11,1,0.541666667
Patrick Patterson,202335,2017-18,1225,80,57,37,30,7,15,33,11,18,15,2462,11.63465024,1341,128,2,0.627373169
Aaron Gordon,203932,2017-18,1909,58,136,40,29,11,70,107,29,56,51,3943,24.19281492,2333,269,13,0.572825349
Jamel Artis,1628503,2017-18,279,15,18,11,8,3,5,8,2,3,5,553,14.44270016,265,46,4,0.347222222
Jonathan Isaac,1628371,2017-18,535,27,18,8,6,2,3,27,7,11,16,1074,15.53480475,563,39,2,0.222415868
Arron Afflalo,201167,2017-18,682,53,30,16,11,5,9,21,7,11,10,1347,13.11365165,538,80,3,0.607270779
Marreese Speights,201578,2017-18,675,52,40,13,9,4,20,40,9,23,17,1358,27.47179827,892,68,2,0.526973925
Mario Hezonja,1626209,2017-18,1657,75,106,29,23,6,57,86,27,37,49,3344,20.0750469,1846,199,11,0.515962151
Nikola Vucevic,202696,2017-18,1683,57,191,74,59,15,83,109,45,45,64,3500,25.74850299,2691,331,12,0.612612751
Evan Fournier,203095,2017-18,1837,57,165,62,39,23,66,95,31,39,56,3824,23.0495613,1328,285,18,0.615685705
Bismack Biyombo,202687,2017-18,1495,82,66,16,13,3,23,84,17,51,33,2964,15.03267974,1961,107,2,0.252759281
D.J. Augustin,201571,2017-18,1760,75,287,92,65,27,107,123,53,47,76,3582,18.62622211,3052,626,35,0.714877619
Rodney Purvis,1628681,2017-18,290,16,17,6,4,2,9,10,2,7,3,577,18.98148148,218,35,4,0.449019608
Jonathon Simmons,203613,2017-18,2029,69,171,88,71,17,45,145,42,53,92,4130,21.98209998,1807,372,17,0.622157816
Khem Birch,203920,2017-18,578,42,34,14,14,0,8,21,2,17,4,1144,13.38403042,643,51,6,0.417784428
Wes Iwundu,1628411,2017-18,1020,62,57,24,22,2,23,30,15,11,19,2016,11.79307321,846,110,13,0.517983737
Terrence Ross,203082,2017-18,600,24,38,13,10,3,15,29,13,14,15,1250,17.09090909,473,73,6,0.507095684
Jerryd Bayless,201573,2017-18,908,38,54,20,16,4,15,46,13,23,23,1925,15.06660542,796,116,14,0.421630095
Justin Anderson,1626147,2017-18,515,37,25,8,7,1,13,16,6,9,7,1052,19.69823973,496,51,6,0.56268504
Amir Johnson,101161,2017-18,1170,74,118,33,31,2,44,56,16,31,25,2419,12.91848617,1592,199,8,0.465484986
Timothe Luwawu-Cabarrot,1627789,2017-18,795,51,54,14,11,3,29,38,11,20,18,1675,17.37532808,683,94,7,0.560935331
Dario Saric,203967,2017-18,2277,77,202,72,62,10,91,148,52,65,83,4749,20.90909091,3442,365,19,0.55300206
Demetrius Jackson,1627743,2017-18,80,15,9,3,3,0,3,10,4,4,6,163,15.84699454,148,27,0,0.133333333
T.J. McConnell,204456,2017-18,1680,75,303,121,92,29,130,112,53,49,63,3526,13.83299799,3336,611,44,0.854393458
JJ Redick,200755,2017-18,2086,69,210,74,64,10,106,103,42,42,61,4413,21.30487314,1982,356,36,0.676676623
Marco Belinelli,201158,2017-18,1921,79,148,54,32,22,51,94,40,36,58,3990,20.3662842,2004,316,29,0.492634655
Markelle Fultz,1628365,2017-18,253,14,53,23,16,7,20,17,3,8,9,543,22.54901961,453,104,3,0.301516833
Joel Embiid,203954,2017-18,1882,62,199,73,55,18,71,231,51,112,119,3904,34.16134913,3136,353,18,0.51869778
Richaun Holmes,1626158,2017-18,729,47,61,21,20,1,18,25,7,14,11,1546,16.42897889,986,104,3,0.407482115
Ersan Ilyasova,101141,2017-18,1730,69,90,32,19,13,28,72,22,38,34,3511,18.85598583,2363,166,16,0.342129366
Ben Simmons,1627732,2017-18,2703,80,661,302,256,46,250,278,115,124,154,5665,22.35404308,5926,1368,82,1.054064167
Furkan Korkmaz,1627788,2017-18,80,14,4,0,0,0,4,2,0,1,1,174,16.24365482,56,6,3,0.5
Robert Covington,203496,2017-18,2501,79,156,55,41,14,73,126,45,62,64,5219,17.24488069,2634,259,27,0.519755431
Marquese Chriss,1627737,2017-18,1527,72,83,27,21,6,22,107,32,59,48,3169,18.17930271,2104,194,15,0.326747222
Devin Booker,1626164,2017-18,1865,54,253,88,59,29,133,194,76,76,118,3948,30.83966056,2096,516,28,0.860294122
Elfrid Payton,203901,2017-18,1809,63,393,147,116,31,159,168,71,63,105,3739,21.5835917,3061,815,35,0.953737298
Jared Dudley,201162,2017-18,687,48,78,26,19,7,37,28,16,10,18,1407,10.52631579,1184,146,4,0.595902266
Tyson Chandler,2199,2017-18,1151,46,53,8,7,1,17,59,24,31,28,2357,10.80178174,1255,124,8,0.186709877
Tyler Ulis,1627755,2017-18,1658,71,311,115,87,28,157,127,75,36,91,3395,18.83606131,2993,622,28,0.88538862
Shaquille Harrison,1627885,2017-18,384,23,55,24,20,4,22,22,11,8,14,806,18.02002225,578,105,5,0.290909091
Brandon Knight,202688,2017-18,0,0,0,0,0,0,0,0,0,0,0,0,0,0,0,0,0
T.J. Warren,203933,2017-18,2142,65,85,38,30,8,28,85,23,48,37,4440,24.83660131,1592,199,16,0.515943044
Alan Williams,1626210,2017-18,70,5,8,7,4,3,1,7,3,4,3,141,18.58974359,88,15,0,0.523809524
Josh Jackson,1628367,2017-18,1959,77,119,44,20,24,64,146,49,59,87,4083,26.06624811,1599,237,9,0.644797283
Alex Len,203458,2017-18,1395,69,82,32,22,10,25,79,25,43,36,2919,16.91934506,1627,177,5,0.445560787
Danuel House Jr.,1627863,2017-18,403,23,25,11,10,1,11,11,4,6,5,820,16.59388646,327,50,2,0.395151515
Alec Peters,1628409,2017-18,225,20,12,5,4,1,5,4,3,0,4,467,15.51724138,237,16,1,0.166666667
Troy Daniels,203584,2017-18,1622,79,48,15,11,4,19,56,20,26,30,3335,17.4282678,1247,130,14,0.380826737
Davon Reed,1628432,2017-18,242,21,13,5,5,0,6,10,2,4,6,506,16.25441696,232,37,2,0.312820513
Dragan Bender,1627733,2017-18,2069,82,130,39,30,9,47,112,45,52,60,4290,12.8716989,3017,255,9,0.357402693
Damian Lillard,203081,2017-18,2670,73,481,148,108,40,219,206,102,61,145,5416,29.92831541,3953,925,56,0.77547404
Evan Turner,202323,2017-18,2034,79,173,66,55,11,66,98,32,37,61,4074,15.64596408,2229,374,13,0.573851839
Wade Baldwin IV,1627735,2017-18,80,7,5,1,1,0,2,4,0,4,0,163,16.20111732,92,7,1,0.266666667
CJ McCollum,203468,2017-18,2924,81,272,105,73,32,108,151,52,56,95,5860,26.48697485,2839,572,40,0.637143707
Maurice Harkless,203090,2017-18,1264,59,53,25,18,7,16,40,9,24,16,2530,12.70506108,1057,123,5,0.520595442
Pat Connaughton,1626192,2017-18,1488,82,91,43,33,10,22,43,17,22,21,2979,13.28424153,1273,171,11,0.467409396
Shabazz Napier,203894,2017-18,1536,74,150,66,51,15,56,90,31,35,55,3029,19.82532751,1899,333,14,0.668448622
Al-Farouq Aminu,202329,2017-18,2072,69,84,29,24,5,35,79,28,34,45,4169,14.74820144,1727,182,16,0.431920909
Jake Layman,1627774,2017-18,160,35,11,6,4,2,1,5,3,0,5,329,14.40217391,127,14,1,-0.03030303
Meyers Leonard,203086,2017-18,254,33,17,11,8,3,4,10,0,7,3,522,16.28721541,355,35,2,0.449019608
Ed Davis,202334,2017-18,1471,78,40,24,16,8,8,66,9,41,25,2852,12.29881567,1952,114,2,0.47630398
Georgios Papagiannis,1627834,2017-18,122,17,9,5,5,0,1,8,0,6,2,247,17.85714286,185,13,1,0.25
C.J. Wilcox,203912,2017-18,0,0,0,0,0,0,0,0,0,0,0,0,0,0,0,0,0
Jusuf Nurkic,203994,2017-18,2088,79,143,52,38,14,64,183,50,92,91,4206,26.34238787,3184,281,11,0.534931871
Zach Collins,1628380,2017-18,1045,66,52,21,15,6,15,58,16,32,26,2041,15.83044983,867,91,4,0.401590042
Caleb Swanigan,1628403,2017-18,189,27,14,7,6,1,7,18,2,11,7,372,19.63048499,159,31,0,0.537037037
Willie Cauley-Stein,1626161,2017-18,2044,73,172,42,31,11,78,108,28,54,54,4027,21.97070573,2906,290,14,0.439346619
De'Aaron Fox,1628368,2017-18,2026,73,320,115,82,33,111,173,75,58,115,4065,23.18521777,3714,626,39,0.62887135
Skal Labissiere,1627746,2017-18,1240,60,72,33,25,8,16,73,18,36,37,2454,21.01449275,1414,133,6,0.379589921
Bogdan Bogdanovic,203992,2017-18,2175,78,258,84,66,18,109,125,64,45,80,4295,19.60825172,2747,512,38,0.623182795
Iman Shumpert,202697,2017-18,276,14,17,8,8,0,5,16,8,6,10,565,12.85714286,316,27,5,0.223039216
Frank Mason,1628412,2017-18,984,52,147,52,31,21,47,65,26,26,39,1878,23.30827068,1689,306,24,0.632283955
Vince Carter,1713,2017-18,1026,58,69,24,19,5,29,36,18,16,20,2005,14.7396293,1278,129,8,0.476267385
Garrett Temple,202066,2017-18,1615,65,124,33,19,14,59,78,35,29,49,3160,16.4058133,1812,229,21,0.467375798
Harry Giles III,1628385,2017-18,0,0,0,0,0,0,0,0,0,0,0,0,0,0,0,0,0
Bruno Caboclo,203998,2017-18,106,12,4,1,1,0,2,4,4,0,4,207,16.10169492,123,4,0,0.083333333
Buddy Hield,1627741,2017-18,2024,80,155,49,36,13,61,124,43,45,79,3956,24.29885573,1890,312,19,0.483208057
Justin Jackson,1628382,2017-18,1506,68,74,34,20,14,23,40,20,15,25,2985,14.23401689,1345,136,11,0.42002429
JaKarr Sampson,203960,2017-18,344,22,9,4,4,0,1,8,1,6,2,666,12.70053476,332,28,0,0.138888889
Nigel Hayes,1628502,2017-18,122,9,6,5,5,0,0,2,1,0,2,224,13.79310345,152,11,0,0.166666667
Kosta Koufos,201585,2017-18,1391,71,87,35,29,6,13,49,9,26,23,2692,15.41734861,1977,167,8,0.266457153
Jack Cooley,204022,2017-18,87,7,6,1,1,0,2,3,0,3,0,162,19.59798995,90,8,0,0.166666667
Zach Randolph,2216,2017-18,1508,59,127,37,28,9,50,116,39,47,69,2964,27.56352765,2054,263,14,0.455876201
Kyle Anderson,203937,2017-18,1978,74,202,77,62,15,81,94,40,42,52,3877,13.65820178,2342,381,33,0.619747997
Kawhi Leonard,202695,2017-18,210,9,21,7,3,4,5,16,9,6,10,418,31.29102845,215,46,2,0.029761905
Brandon Paul,203464,2017-18,576,64,37,14,8,6,13,29,15,9,20,1171,13.38944147,520,73,6,0.433632065
Derrick White,1628401,2017-18,139,17,9,2,2,0,6,6,2,1,5,287,15.03067485,180,16,0,0.277777778
Dejounte Murray,1627749,2017-18,1743,81,231,78,52,26,70,134,42,56,78,3421,20.73201945,3306,464,56,0.519888022
Patty Mills,201988,2017-18,2107,82,229,75,51,24,69,106,50,37,69,4149,17.6957352,2930,451,57,0.44647982
Tony Parker,2225,2017-18,1071,55,195,73,47,26,56,68,30,22,46,2106,20.8139042,1968,359,38,0.620334378
Matt Costello,1627856,2017-18,32,4,2,2,2,0,0,1,0,0,1,64,7.142857143,38,4,0,0.333333333
Bryn Forbes,1627854,2017-18,1517,80,80,31,20,11,25,37,8,18,19,3018,16.45643884,1111,150,20,0.429388364
LaMarcus Aldridge,200746,2017-18,2509,75,152,69,52,17,35,111,23,61,50,4862,29.35431362,2849,285,42,0.414353215
Danny Green,201980,2017-18,1791,70,110,27,13,14,34,74,40,26,48,3478,16.74242424,1985,199,22,0.216358905
Pau Gasol,2200,2017-18,1812,77,238,50,44,6,117,108,53,33,75,3566,20.66218571,3182,385,15,0.47033135
Manu Ginobili,1938,2017-18,1299,65,163,47,33,14,78,105,57,32,73,2603,21.11337407,1469,320,21,0.665970404
Rudy Gay,200752,2017-18,1231,57,73,28,20,8,32,77,28,35,42,2425,24.36219907,1557,164,10,0.545322078
Darrun Hilliard,1626199,2017-18,95,14,11,5,4,1,4,4,0,3,1,193,12.26415094,107,16,0,0.401515152
Davis Bertans,202722,2017-18,1086,77,74,28,16,12,27,36,19,13,23,2174,17.3679868,1411,109,7,0.374565448
Joffrey Lauvergne,203530,2017-18,534,55,41,11,6,5,18,33,5,24,9,1083,20,576,79,3,0.568167502
CJ Miles,101139,2017-18,1337,70,55,11,6,5,36,39,10,17,22,2714,22.08005249,892,90,8,0.501389678
OG Anunoby,1628384,2017-18,1481,74,55,25,16,9,17,45,14,19,26,3000,12.40333135,892,92,12,0.40296964
Lorenzo Brown,203485,2017-18,139,14,13,9,7,2,3,3,0,2,1,271,12.66666667,196,23,4,0.478632479
Kyle Lowry,200768,2017-18,2510,78,537,135,89,46,268,183,100,57,126,5118,21.46460254,4484,951,41,0.778595903
Serge Ibaka,201586,2017-18,2093,76,62,29,18,11,21,89,18,49,40,4268,19.33458883,2252,152,12,0.463424134
DeMar DeRozan,201942,2017-18,2712,80,417,201,145,56,136,175,67,62,113,5535,29.13663303,3006,828,62,0.840340885
Malcolm Miller,1626259,2017-18,126,15,3,1,1,0,1,5,1,3,2,254,11.66666667,107,7,1,0.2
Jonas Valanciunas,202685,2017-18,1727,77,81,40,32,8,27,115,21,59,56,3496,22.71461129,2716,159,12,0.482117462
Malachi Richardson,1627781,2017-18,323,26,13,4,2,2,7,10,1,6,4,648,15.21438451,267,29,2,0.379487179
Fred VanVleet,1627832,2017-18,1520,76,243,87,50,37,115,74,29,30,44,3008,19.47631656,2244,483,42,0.832747988
Norman Powell,1626181,2017-18,1062,70,89,40,26,14,33,66,17,34,32,2143,19.14983165,956,185,14,0.692989492
Alfonzo McKinnie,1628035,2017-18,53,14,1,1,1,0,0,3,2,1,2,113,15.96638655,44,3,1,0.444444444
Jakob Poeltl,1627751,2017-18,1524,82,57,33,22,11,15,85,16,52,33,3040,14.77603258,1681,112,10,0.519477987
Pascal Siakam,1627783,2017-18,1679,81,159,69,49,20,75,67,24,30,37,3336,15.93391953,2406,253,16,0.644086156
Delon Wright,1626153,2017-18,1433,69,200,97,62,35,76,78,33,33,45,2848,17.380509,2246,410,31,0.808018774
Lucas Nogueira,203512,2017-18,418,49,22,12,8,4,8,16,5,9,7,848,11.67567568,458,44,3,0.429924242
Joe Ingles,204060,2017-18,2579,82,392,102,61,41,210,159,88,55,104,5130,15.94202899,3175,708,37,0.74207282
Ricky Rubio,201937,2017-18,2254,77,410,158,86,72,190,206,117,61,145,4458,22.87031469,4573,810,53,0.817307071
David Stockton,204065,2017-18,9,3,0,0,0,0,0,1,1,0,1,21,25,13,2,0,0
Jonas Jerebko,201973,2017-18,1134,74,42,20,18,2,12,27,8,16,11,2230,15.6761069,1655,89,7,0.42502864
Alec Burks,202692,2017-18,1059,64,67,26,15,11,28,60,19,26,34,2093,22.94372294,1076,138,16,0.54231233
Dante Exum,203957,2017-18,235,14,43,14,12,2,18,20,8,10,10,474,23.10606061,349,66,3,0.244186047
Tony Bradley,1628396,2017-18,29,9,1,0,0,0,1,0,0,0,0,62,16.66666667,27,1,0,0
Derrick Favors,202324,2017-18,2153,77,102,50,34,16,36,88,14,60,28,4221,18.65230249,3024,189,12,0.554027802
Erik McCree,1628571,2017-18,8,4,0,0,0,0,0,1,0,0,1,16,16.66666667,7,2,0,0
Thabo Sefolosha,200757,2017-18,806,38,33,13,7,6,18,30,10,13,17,1590,16.78998293,969,87,10,0.614895446
Royce O'Neale,1626220,2017-18,1150,69,95,38,19,19,38,55,22,24,31,2267,14.48034255,1098,194,12,0.624168413
Raul Neto,203526,2017-18,498,41,75,35,22,13,26,36,22,12,24,1006,18.05183199,883,149,8,0.257777778
Rudy Gobert,203497,2017-18,1816,56,80,30,25,5,26,106,16,58,48,3640,16.57310227,2612,161,10,0.366018249
Georges Niang,1627777,2017-18,32,9,3,0,0,0,2,3,2,1,2,71,19.23076923,28,2,0,0.111111111
Ekpe Udoh,202327,2017-18,810,63,53,27,18,9,15,20,3,14,6,1614,9.249858996,943,98,2,0.584030799
Donovan Mitchell,1628378,2017-18,2638,79,291,130,77,53,123,216,75,74,142,5268,28.88662593,2941,541,37,0.705977315
Jae Crowder,203109,2017-18,2090,80,99,45,34,11,40,74,23,41,33,4233,17.39316239,2227,155,11,0.520366915
Chris McCullough,1626191,2017-18,90,19,4,1,1,0,2,2,1,0,2,199,22.36842105,127,8,0,0.083333333
John Wall,202322,2017-18,1410,41,393,144,112,32,149,158,78,42,116,2897,28.77008653,2222,720,29,1.002158703
Bradley Beal,203078,2017-18,2977,82,373,132,95,37,121,214,88,70,144,5971,27.42899851,3708,741,92,0.569398268
Ty Lawson,201951,2017-18,0,0,0,0,0,0,0,0,0,0,0,0,0,0,0,0,0
Markieff Morris,202693,2017-18,1968,73,142,46,34,12,51,127,33,79,48,3912,19.85378113,1865,240,16,0.474418553
Devin Robinson,1628421,2017-18,13,1,0,0,0,0,0,0,0,0,0,28,8.571428571,17,3,0,0
Tim Frazier,204025,2017-18,838,59,194,69,55,14,55,57,28,22,35,1652,13.00160514,1622,369,11,0.768994608
Ramon Sessions,201196,2017-18,392,28,77,27,21,6,23,30,17,8,22,784,19.32960894,694,139,10,0.071572872
Kelly Oubre Jr.,1626162,2017-18,2231,81,98,33,28,5,35,90,29,41,49,4523,19.30100137,1713,181,12,0.365854855
Marcin Gortat,101162,2017-18,2074,82,151,59,46,13,47,98,26,61,37,4147,15.71244081,2688,261,12,0.465745076
Jason Smith,201160,2017-18,285,33,14,7,6,1,5,15,4,10,5,594,21.00456621,377,34,3,0.412698413
Jodie Meeks,201975,2017-18,1119,77,70,18,14,4,22,37,17,15,22,2252,18.6228482,983,142,8,0.311251805
Otto Porter Jr.,203490,2017-18,2432,77,157,51,40,11,50,75,31,29,46,4864,18.640955,2603,305,28,0.348118002
Ian Mahinmi,101133,2017-18,1145,77,53,14,12,2,21,101,23,66,35,2269,15.59984668,1213,94,12,0.371122361
Mike Scott,203118,2017-18,1406,76,80,32,24,8,30,79,18,45,34,2808,19.98738966,1607,165,9,0.518236741
Tomas Satoransky,203107,2017-18,1643,73,286,88,67,21,86,83,40,25,58,3284,13.79589633,2899,547,26,0.563739873
Paul Millsap,200794,2016-17,2343,69,252,96,54,42,111,158,55,63,95,4765,24.56008985,3044,516,32,0.677417569
Malcolm Delaney,1627098,2016-17,1248,73,193,74,60,14,79,95,50,34,61,2485,18.68289191,2092,427,23,0.791636027
Ersan Ilyasova,101141,2016-17,2142,82,141,48,36,12,66,116,42,56,60,4397,22.02369002,2994,243,9,0.497371215
Dwight Howard,2730,2016-17,2199,74,104,27,16,11,44,170,35,110,60,4407,19.33056051,2927,204,13,0.394177291
Tim Hardaway Jr.,203501,2016-17,2154,79,182,54,35,19,78,106,49,40,66,4379,22.36789028,2046,346,32,0.514136065
Taurean Prince,1627752,2016-17,981,59,55,22,15,7,24,61,28,27,34,1985,17.16054843,809,108,10,0.560827842
Jose Calderon,101181,2016-17,539,41,88,24,20,4,32,41,27,10,31,1079,14.28571429,1087,176,15,0.539441918
Dennis Schroder,203471,2016-17,2485,79,499,160,120,40,216,258,124,88,170,5038,27.60070053,4658,975,58,0.802206866
Kent Bazemore,203145,2016-17,1963,73,177,41,26,15,99,125,66,34,91,3969,20.56595365,2058,318,26,0.531476346
Thabo Sefolosha,200757,2016-17,1596,62,107,39,29,10,39,58,26,24,34,3193,13.51949129,1784,219,22,0.460212223
Ryan Kelly,203527,2016-17,110,16,8,2,2,0,5,4,1,2,2,219,14.58333333,141,13,0,0.375
Mike Muscala,203488,2016-17,1237,70,95,40,30,10,33,55,26,21,34,2484,14.92007105,1555,193,13,0.509165504
Mike Dunleavy,2399,2016-17,841,53,50,21,11,10,18,28,12,12,16,1692,14.20212766,726,111,8,0.541068769
Kris Humphries,2743,2016-17,689,56,29,10,9,1,9,28,6,15,13,1370,18.21127673,1129,76,8,0.344698174
DeAndre' Bembry,1627761,2016-17,371,38,28,14,11,3,7,16,7,6,10,728,14.6878825,376,69,1,0.208333333
Avery Bradley,202340,2016-17,1835,55,121,46,35,11,43,88,41,28,60,3682,21.87424132,1750,271,27,0.477472196
Isaiah Thomas,202738,2016-17,2569,76,449,192,133,59,171,210,76,70,140,5203,33.73556283,4314,870,91,0.793229853
Jaylen Brown,1627759,2016-17,1341,78,64,28,18,10,22,68,15,40,28,2661,18.24005394,1126,124,10,0.513254406
Jonas Jerebko,201973,2016-17,1232,78,71,34,29,5,21,39,15,19,20,2438,11.62705667,1926,127,8,0.43939857
Demetrius Jackson,1627743,2016-17,17,5,3,0,0,0,3,0,0,0,0,35,16.27906977,18,4,0,0
Terry Rozier,1626179,2016-17,1263,74,131,50,38,12,44,47,20,18,29,2507,17.25852273,2206,276,25,0.522190803
James Young,203923,2016-17,220,29,4,2,1,1,1,4,2,1,3,453,12.79527559,155,24,2,0.166666667
Gerald Green,101123,2016-17,538,47,33,10,9,1,19,25,10,8,17,1070,22.93577982,418,56,3,0.55684839
Marcus Smart,203935,2016-17,2399,79,364,141,104,37,163,159,70,61,98,4850,18.70067902,3403,705,45,0.797423359
Kelly Olynyk,203482,2016-17,1538,75,148,56,42,14,64,96,31,45,51,3094,19.08352668,2494,291,11,0.606280938
Al Horford,201143,2016-17,2193,68,337,123,81,42,138,115,46,44,71,4393,19.91803279,3471,661,29,0.727198899
Tyler Zeller,203092,2016-17,525,51,42,15,14,1,15,20,10,8,12,1053,16.44182125,584,75,1,0.452234181
Jordan Mickey,1626175,2016-17,141,25,7,3,2,1,2,9,1,4,5,284,15.17027864,196,22,1,0.195767196
Amir Johnson,101161,2016-17,1608,80,140,61,40,21,45,77,27,38,39,3156,13.81930763,1914,238,18,0.527335223
Jae Crowder,203109,2016-17,2335,72,155,63,44,19,58,80,39,30,50,4706,17.08341287,2646,287,28,0.470356309
Randy Foye,200751,2016-17,1277,68,135,62,41,21,41,80,36,33,47,2698,14.56016178,1559,299,13,0.659728427
Sean Kilpatrick,203930,2016-17,1730,69,157,72,52,20,55,135,45,48,87,3682,23.73872776,2019,325,27,0.609601099
Jeremy Lin,202391,2016-17,858,35,184,54,35,19,90,86,37,29,57,1919,25.94517958,1532,352,12,0.868366553
Spencer Dinwiddie,203915,2016-17,1312,58,185,87,58,29,69,66,27,36,30,2731,14.35185185,2053,389,15,0.844367472
Archie Goodwin,203462,2016-17,214,15,24,8,6,2,11,14,6,4,10,434,21.06382979,278,46,2,0.220238095
Brook Lopez,201572,2016-17,2222,75,176,68,52,16,93,184,50,86,98,4706,28.95849347,2244,371,10,0.736199627
Joe Harris,203925,2016-17,1116,51,54,19,9,10,20,55,20,23,32,2425,16.17052554,1040,144,6,0.462443291
Quincy Acy,203112,2016-17,558,38,18,6,3,3,9,21,5,10,11,1135,17.03296703,654,33,3,0.434995326
KJ McDaniels,203909,2016-17,506,49,13,2,0,2,10,29,11,10,19,1035,18.40753425,325,37,3,0.558321469
Isaiah Whitehead,1627785,2016-17,1643,73,192,76,56,20,90,142,53,54,88,3391,18.45788223,2082,400,23,0.760257279
Caris LeVert,1627747,2016-17,1218,56,110,52,38,14,47,59,25,23,36,2625,16.52382585,1208,210,13,0.709531689
Rondae Hollis-Jefferson,1626178,2016-17,1741,77,154,67,54,13,57,116,46,44,72,3729,18.83528265,2753,310,16,0.555627939
Trevor Booker,202344,2016-17,1734,70,138,80,63,17,36,127,29,56,71,3647,18.88284726,3247,303,12,0.588952063
Justin Hamilton,203120,2016-17,1153,63,55,24,20,4,22,43,14,14,29,2469,16.19846771,1555,116,9,0.453429284
Andrew Nicholson,203094,2016-17,342,38,10,4,3,1,3,17,3,9,8,677,17.73333333,376,18,4,0.209803922
Briante Weber,1627362,2016-17,205,20,21,12,10,2,3,8,3,2,6,382,17.20183486,366,37,2,0.130952381
Marvin Williams,101107,2016-17,2295,76,106,40,38,2,39,60,18,35,25,4521,16.36076574,3816,239,21,0.439831257
Jeremy Lamb,203087,2016-17,1143,62,75,25,19,6,27,40,19,15,25,2217,23.43686971,1009,171,19,0.470747693
Nicolas Batum,201587,2016-17,2617,77,456,137,109,28,218,194,102,58,136,5212,21.85886403,3396,879,47,0.806213164
Ramon Sessions,201196,2016-17,811,50,129,33,26,7,47,46,23,13,33,1640,19.92316136,1305,278,25,0.603504774
Johnny O'Bryant III,203948,2016-17,81,11,6,4,4,0,2,6,1,4,2,164,21.19565217,57,9,0,0.555555556
Treveon Graham,1626203,2016-17,189,27,6,3,3,0,1,3,1,1,2,371,12.13592233,142,26,0,0.111111111
Michael Kidd-Gilchrist,203077,2016-17,2349,81,114,52,42,10,30,56,11,30,26,4587,14.72463768,1769,233,21,0.462106985
Kemba Walker,202689,2016-17,2739,79,434,153,133,20,152,168,68,49,119,5422,29.08911217,4738,916,67,0.661079675
Miles Plumlee,203101,2016-17,485,45,21,7,5,2,7,30,5,17,13,937,13.22001889,318,49,0,0.188888889
Marco Belinelli,201158,2016-17,1778,74,147,53,41,12,56,70,30,23,47,3558,19.18856851,1442,288,24,0.546056102
Brian Roberts,203148,2016-17,416,41,52,16,12,4,17,26,11,13,13,808,18.73589165,687,104,10,0.134615385
Christian Wood,1626174,2016-17,107,13,2,1,0,1,1,7,0,4,3,205,15.61181435,89,7,1,0.523809524
Cody Zeller,203469,2016-17,1725,62,99,40,31,9,33,65,18,36,29,3406,15.55555556,1197,243,14,0.599199539
Frank Kaminsky,1626163,2016-17,1954,75,162,63,54,9,53,76,23,35,41,3893,22.06671332,2805,307,14,0.469452516
Isaiah Canaan,203477,2016-17,592,39,37,13,8,5,11,21,9,11,10,1155,15.49925484,660,76,3,0.40011505
Jerian Grant,1626170,2016-17,1028,63,121,30,22,8,48,44,21,17,27,2022,16.18472162,1339,227,11,0.497095932
Dwyane Wade,2548,2016-17,1792,60,228,62,31,31,101,138,66,42,96,3568,29.35359383,1976,442,20,0.620030886
Bobby Portis,1626171,2016-17,1001,64,35,16,11,5,12,37,8,25,12,1982,19.41618753,1529,92,5,0.510636696
Cristiano Felicio,1626245,2016-17,1040,66,40,22,16,6,11,33,7,15,18,2040,12.59038707,1075,92,8,0.483891419
Michael Carter-Williams,203487,2016-17,846,45,113,42,26,16,30,66,28,27,39,1678,20.7498716,1388,193,10,0.47404649
Robin Lopez,201577,2016-17,2271,81,80,22,15,7,33,91,22,53,38,4490,17.44297489,1686,182,7,0.40306124
Rajon Rondo,200765,2016-17,1843,69,461,117,77,40,174,169,79,72,97,3667,17.74421897,4009,889,43,0.810698378
Anthony Morrow,201627,2016-17,714,49,25,8,4,4,12,6,2,3,3,1461,16.04215457,336,47,1,0.505707283
Paul Zipser,1627835,2016-17,843,44,36,13,7,6,13,40,12,19,21,1674,14.56158664,711,64,4,0.379822289
Jimmy Butler,202710,2016-17,2809,76,417,125,75,50,115,159,65,59,100,5588,26.47515528,3471,886,47,0.603235218
Cameron Payne,1626166,2016-17,462,31,55,14,7,7,28,29,11,12,17,926,21.58548233,672,128,7,0.234900731
Nikola Mirotic,202703,2016-17,1679,70,75,23,15,8,34,80,38,28,52,3352,19.8642652,2648,156,11,0.361824835
Denzel Valentine,1627756,2016-17,977,57,63,24,14,10,16,49,21,22,27,1944,15.660463,784,118,8,0.389201928
Joffrey Lauvergne,203530,2016-17,980,70,70,19,12,7,32,56,17,28,28,1953,18.94783772,1156,128,2,0.469910317
Kevin Love,201567,2016-17,1885,60,116,40,22,18,64,122,43,47,75,3794,25.71756602,2411,192,23,0.539792128
James Jones,2592,2016-17,381,48,14,7,5,2,4,10,5,4,6,755,13.69863014,424,26,1,0.252380952
Kyrie Irving,202681,2016-17,2525,72,418,177,121,56,162,180,71,70,110,5064,29.90247301,3789,848,50,0.833615085
Derrick Williams,202682,2016-17,804,50,28,14,10,4,10,28,6,18,10,1586,17.87137166,911,59,3,0.542908985
Iman Shumpert,202697,2016-17,1937,76,109,47,29,18,38,78,32,37,41,3830,14.31924883,1401,221,25,0.543107933
JR Smith,2747,2016-17,1187,41,62,24,19,5,26,26,12,9,17,2372,14.5802099,926,121,10,0.487776766
Channing Frye,101112,2016-17,1398,74,45,22,12,10,18,53,13,32,21,2793,19.80392157,1768,102,21,0.554133765
Tristan Thompson,202684,2016-17,2336,78,77,39,27,12,23,64,11,40,24,4622,11.36363636,2346,170,22,0.492099213
Kay Felder,1627770,2016-17,386,42,58,34,22,12,15,30,11,15,15,775,25.0887574,537,109,3,0.344827586
LeBron James,2544,2016-17,2795,74,646,349,188,161,199,302,131,118,184,5558,29.73877031,4396,1283,74,1.062763595
Richard Jefferson,2210,2016-17,1614,79,78,32,24,8,30,52,14,32,20,3225,12.33566434,1259,141,15,0.532687574
Kyle Korver,2594,2016-17,1753,67,110,32,21,11,51,68,29,26,42,3554,15.00252143,1336,175,8,0.446146657
Dahntay Jones,2563,2016-17,12,1,1,1,1,0,0,1,0,1,0,20,41.66666667,18,2,0,0.666666667
Deron Williams,101114,2016-17,1625,63,360,149,113,36,105,138,67,49,89,3191,22.25085911,3240,681,41,0.786508485
Edy Tavares,204002,2016-17,28,2,1,1,1,0,0,2,1,1,1,52,13.33333333,26,1,0,0.5
Nerlens Noel,203457,2016-17,1047,51,50,16,12,4,25,51,10,28,23,2076,17.73633998,1105,93,8,0.50932798
J.J. Barea,200826,2016-17,751,34,193,44,30,14,90,63,37,17,46,1497,26.20647526,1503,342,12,0.800518661
Manny Harris,202412,2016-17,25,4,2,1,1,0,0,2,2,0,2,49,29.6875,40,8,1,-0.166666667
Dwight Powell,203939,2016-17,1318,76,49,27,20,7,12,34,10,17,17,2542,16.71957672,1442,124,11,0.475991988
Nicolas Brussino,1627852,2016-17,521,54,47,12,10,2,22,26,11,12,14,1024,15.13327601,659,111,1,0.592072592
Dorian Finney-Smith,1627827,2016-17,1632,80,67,40,20,20,13,45,16,20,25,3096,11.84172243,1479,166,8,0.486479943
Yogi Ferrell,1627812,2016-17,1197,46,172,75,56,19,41,70,33,26,44,2332,19.71830986,2023,394,25,0.655477943
DeAndre Liggins,202732,2016-17,777,62,54,26,19,7,21,42,14,25,17,1532,11.62521689,816,116,7,0.693565414
Jarrod Uthoff,1627784,2016-17,115,9,9,4,3,1,2,3,1,0,3,222,17.12062257,121,17,2,0
AJ Hammons,1627773,2016-17,163,22,4,2,2,0,1,10,0,10,0,320,16.80216802,100,22,0,0.416666667
Wesley Matthews,202083,2016-17,2457,72,210,101,79,22,37,102,40,34,68,4773,19.67748128,2483,429,17,0.448965345
Seth Curry,203552,2016-17,2005,69,189,67,56,11,52,92,36,48,44,3870,19.65003547,2632,398,27,0.486595553
Devin Harris,2734,2016-17,1071,64,136,41,31,10,56,57,28,20,37,2104,19.62978907,1339,263,12,0.60550782
Harrison Barnes,203084,2016-17,2767,78,116,90,69,21,11,102,34,33,69,5372,25.65677243,2488,297,20,0.538575582
Dirk Nowitzki,1717,2016-17,1394,53,82,38,27,11,27,51,17,19,32,2808,25.337282,1666,154,13,0.453109699
Salah Mejri,1626257,2016-17,889,72,14,6,5,1,2,40,8,26,14,1700,10.77085533,934,49,7,0.229009208
Darrell Arthur,201589,2016-17,639,41,42,15,11,4,18,36,13,18,18,1287,18.03051318,743,78,5,0.512759825
Emmanuel Mudiay,1626144,2016-17,1384,54,217,54,42,12,97,123,37,49,74,2900,22.49249249,2347,382,26,0.600749728
Jameer Nelson,2749,2016-17,2021,74,385,147,105,42,148,128,55,55,73,4166,15.82898853,3464,689,39,0.782619605
Mike Miller,2034,2016-17,148,19,22,10,6,4,8,13,8,5,8,324,10.30640669,263,35,0,0.27972028
Will Barton,203115,2016-17,1681,59,206,95,77,18,75,97,36,35,62,3460,21.07107107,1789,418,26,0.761162561
Danilo Gallinari,201568,2016-17,2104,62,135,39,32,7,61,82,33,26,56,4357,20.08830022,1929,264,23,0.442098892
Gary Harris,203914,2016-17,1748,56,164,79,60,19,61,76,37,28,48,3660,18.53365385,1349,295,14,0.697243694
Nikola Jokic,203999,2016-17,2008,72,359,97,80,17,214,171,60,73,98,4206,23.45936912,3675,613,18,0.814010398
Wilson Chandler,201163,2016-17,2165,70,141,73,54,19,42,114,33,57,57,4485,22.08121827,2182,286,37,0.578776864
Mason Plumlee,203486,2016-17,2148,81,284,96,78,18,120,134,47,60,74,4299,18.35390947,2746,556,20,0.704472212
Malik Beasley,1627736,2016-17,162,21,11,3,3,0,5,8,2,5,3,359,21.71717172,119,21,1,0.268939394
Jamal Murray,1627750,2016-17,1754,81,170,61,49,12,75,113,49,38,75,3614,21.61439339,2032,323,35,0.588534935
Roy Hibbert,201579,2016-17,682,48,21,10,8,2,6,32,6,19,13,1369,14.05228758,335,48,4,0.506819576
Kenneth Faried,202702,2016-17,1280,60,55,18,13,5,26,59,18,27,32,2631,18.23817292,1309,119,6,0.469753547
Juan Hernangomez,1627823,2016-17,839,61,29,14,11,3,6,31,6,15,16,1740,14.3996014,769,70,3,0.358738794
Andre Drummond,203083,2016-17,2409,81,90,32,23,9,26,153,29,85,68,4707,22.56277696,1858,192,15,0.346001005
Reggie Jackson,202704,2016-17,1424,52,270,91,69,22,88,114,57,42,72,2816,26.46967341,2444,577,24,0.760388323
Kentavious Caldwell-Pope,203484,2016-17,2529,76,193,57,47,10,78,86,30,33,53,5002,18.96249562,1921,396,28,0.523448439
Darrun Hilliard,1626199,2016-17,381,39,33,12,6,6,9,28,12,12,16,746,19.59858323,355,70,2,0.112554113
Stanley Johnson,1626169,2016-17,1371,77,105,26,21,5,42,71,21,37,34,2678,14.85917773,1364,197,12,0.44278019
Henry Ellenson,1627740,2016-17,146,19,7,3,3,0,1,14,9,4,10,291,23.80952381,223,14,2,0
Michael Gbinije,1627771,2016-17,32,9,2,1,0,1,0,0,0,0,0,63,15.06849315,29,1,0,0
Aron Baynes,203382,2016-17,1163,75,32,10,7,3,8,50,9,34,16,2280,14.48543689,686,88,1,0.326446263
Marcus Morris,202694,2016-17,2565,79,160,31,21,10,65,87,48,27,60,5043,20.39120651,2555,298,16,0.269594997
Ish Smith,202397,2016-17,1955,81,418,151,107,44,137,112,49,30,82,3856,20.56561086,3768,826,31,0.753335094
Beno Udrih,2757,2016-17,560,39,131,32,25,7,54,36,22,5,31,1087,20.09803922,1105,250,7,0.708791095
Reggie Bullock,203493,2016-17,467,31,29,8,5,3,12,10,5,4,6,933,13.03538175,377,54,3,0.156321839
Jon Leuer,202720,2016-17,1944,75,111,28,22,6,40,66,26,25,41,3819,17.31690623,2575,226,6,0.276230707
Tobias Harris,202699,2016-17,2566,82,142,50,33,17,45,96,24,39,57,5070,21.82166493,3355,317,26,0.355788508
Boban Marjanovic,1626246,2016-17,293,35,9,1,0,1,5,10,1,5,5,589,24.33628319,222,22,3,0.166666667
Patrick McCaw,1627775,2016-17,1074,71,77,30,21,9,34,36,19,13,23,2238,11.82539683,1009,163,14,0.598187708
JaVale McGee,201580,2016-17,739,77,17,7,6,1,6,40,7,23,17,1581,22.40044248,625,48,4,0.431458521
David West,2561,2016-17,854,68,151,28,24,4,90,78,28,37,41,1667,19.63596249,1301,279,13,0.81405826
Kevon Looney,1626172,2016-17,447,53,29,13,9,4,7,17,4,10,7,936,12.87313433,566,57,4,0.219066937
Andre Iguodala,2738,2016-17,1998,76,261,85,63,22,106,58,29,23,35,4133,11.37109119,2524,503,37,0.648356606
Klay Thompson,202691,2016-17,2649,78,160,45,29,16,88,127,58,45,82,5472,26.27509049,2042,308,55,0.549796377
Damian Jones,1627745,2016-17,85,10,0,0,0,0,0,6,0,6,0,171,13.7755102,86,7,0,0
James Michael McAdoo,203949,2016-17,457,52,18,6,4,2,5,19,6,9,10,924,14.84300666,567,53,4,0.102339181
Ian Clark,203546,2016-17,1137,77,90,27,18,9,36,56,25,22,34,2320,19.76163014,1408,176,25,0.44407903
Matt Barnes,2440,2016-17,1776,74,195,58,36,22,85,107,57,40,67,3520,15.78947368,2799,331,20,0.495907653
Draymond Green,203110,2016-17,2471,76,533,182,146,36,224,184,99,71,113,5149,16.26369803,4724,951,47,0.809859475
Zaza Pachulia,2585,2016-17,1268,70,132,42,36,6,59,87,31,43,44,2638,15.29888551,1612,234,22,0.592939683
Stephen Curry,201939,2016-17,2639,79,524,163,113,50,270,239,119,89,150,5621,28.9741956,4167,924,88,0.85567241
Shaun Livingston,2733,2016-17,1345,76,139,41,26,15,47,62,28,25,37,2662,13.49899261,2157,296,27,0.458137441
Kevin Durant,201142,2016-17,2070,62,300,130,95,35,108,138,58,45,93,4353,27.63651521,2385,519,26,0.703697019
Trevor Ariza,2772,2016-17,2773,80,175,76,48,28,69,73,28,36,37,5779,14.19809874,2508,346,25,0.589021469
Patrick Beverley,201976,2016-17,2058,67,281,120,92,28,130,100,46,42,58,4246,14.21751764,2566,577,21,0.86824594
Ryan Anderson,201583,2016-17,2116,72,68,46,35,11,14,55,9,28,27,4374,18.11007689,1941,156,19,0.539478195
Montrezl Harrell,1626149,2016-17,1064,58,64,40,27,13,20,44,17,21,23,2204,17.34939759,1288,111,8,0.620427675
Sam Dekker,1626155,2016-17,1419,77,76,41,36,5,23,41,16,20,21,2920,15.13775356,1388,124,8,0.514762881
Bobby Brown,201628,2016-17,123,25,14,6,6,0,8,5,1,3,2,269,22.37288136,124,21,3,0.533333333
Eric Gordon,201569,2016-17,2323,75,188,75,45,30,98,121,41,52,69,4832,22.07198977,1609,385,15,0.801809808
Lou Williams,101150,2016-17,1993,81,239,39,26,13,149,160,84,48,112,4185,28.1986532,2136,447,22,0.653498872
James Harden,201935,2016-17,2947,81,907,368,272,96,481,464,219,150,314,6147,33.79489399,5233,1810,66,1.337210695
Troy Williams,1627786,2016-17,557,30,25,7,3,4,11,32,13,12,20,1106,17.20257235,420,66,0,0.453968111
Clint Capela,203991,2016-17,1551,65,63,44,34,10,14,87,22,50,37,3164,20.20005557,2077,132,19,0.59419872
Isaiah Taylor,1627819,2016-17,52,4,3,1,1,0,2,0,0,0,0,109,6.666666667,48,6,0,0
Chinanu Onuaku,1627778,2016-17,52,5,3,0,0,0,2,4,1,2,2,109,10.83333333,51,5,0,0.166666667
Kyle Wiltjer,1627787,2016-17,44,14,2,1,1,0,1,5,0,3,2,102,17.85714286,65,4,1,0.533333333
Nene ,2403,2016-17,1198,67,65,36,22,14,27,73,19,38,35,2545,19.39986043,1373,155,9,0.718353867
CJ Miles,101139,2016-17,1756,75,48,13,7,6,22,40,19,15,25,3524,18.28093306,1268,116,11,0.345041875
Aaron Brooks,201166,2016-17,870,64,125,32,23,9,32,66,31,22,44,1746,19.16916917,1350,268,13,0.46300894
Kevin Seraphin,202338,2016-17,539,48,23,10,7,3,9,29,6,15,14,1114,18.99038462,569,66,4,0.570276033
Joe Young,1626202,2016-17,132,32,15,4,1,3,6,5,2,1,4,281,25.69659443,227,47,4,0.066666667
Lavoy Allen,202730,2016-17,868,60,57,21,14,7,18,29,16,7,22,1714,10.63723031,1148,108,5,0.316504248
Lance Stephenson,202362,2016-17,362,18,59,24,17,7,21,26,14,9,17,714,18.55036855,465,135,2,0.211429813
Al Jefferson,2744,2016-17,922,65,57,23,17,6,11,33,6,17,16,1821,26.26213592,1028,115,10,0.338138288
Monta Ellis,101145,2016-17,1971,73,236,78,52,26,85,135,52,53,82,3965,17.01594533,2203,485,28,0.621097818
Paul George,202331,2016-17,2658,74,251,84,47,37,94,219,80,83,136,5375,28.95935234,2704,543,35,0.57393104
Thaddeus Young,201152,2016-17,2209,73,122,42,31,11,52,96,36,36,60,4478,16.63286004,2818,260,14,0.438789471
Rakeem Christmas,1626176,2016-17,219,29,4,0,0,0,3,8,0,6,2,439,12.57253385,132,13,2,0.333333333
Georges Niang,1627777,2016-17,90,22,5,1,1,0,1,5,1,3,2,193,18.66666667,121,13,0,-0.066666667
Myles Turner,1626167,2016-17,2520,80,106,48,24,24,36,105,27,59,46,5086,19.79241231,2685,202,17,0.468479256
Glenn Robinson III,203922,2016-17,1399,68,47,19,15,4,12,37,13,11,26,2862,12.87878788,1097,104,9,0.261149725
Jeff Teague,201952,2016-17,2632,81,639,178,134,44,218,216,98,75,141,5349,22.16941097,4631,1290,65,0.837471511
Diamond Stone,1627754,2016-17,24,7,0,0,0,0,0,2,0,1,1,50,32.0754717,25,0,0,0
Raymond Felton,101109,2016-17,1700,80,191,72,58,14,76,83,36,25,58,3383,16.6577967,2640,390,35,0.585743087
Chris Paul,101108,2016-17,1921,61,563,165,116,49,244,147,59,64,83,3833,24.28838077,3949,1054,59,1.020498994
JJ Redick,200755,2016-17,2198,78,110,31,20,11,62,98,30,45,53,4414,21.51386359,1733,225,37,0.56404755
Marreese Speights,201578,2016-17,1286,82,65,27,19,8,27,69,22,39,30,2560,24.11221591,1602,120,6,0.520727325
DeAndre Jordan,201599,2016-17,2570,81,96,42,30,12,16,114,27,69,45,5114,15.43016371,3247,184,8,0.26751741
Alan Anderson,101187,2016-17,308,30,11,1,1,0,9,7,2,4,3,605,14.04833837,199,20,3,0.432900433
Brice Johnson,1627744,2016-17,9,3,1,1,1,0,0,1,0,1,0,20,34.7826087,14,1,0,0.666666667
Jamal Crawford,2037,2016-17,2157,82,214,65,44,21,112,134,52,48,86,4358,22.47516556,2225,422,25,0.665144139
Luc Mbah a Moute,201601,2016-17,1787,80,39,11,11,0,24,46,16,23,23,3527,11.69888098,1098,77,9,0.510652378
Austin Rivers,203085,2016-17,2054,74,204,95,72,23,61,115,38,47,68,4107,20.26643372,2649,390,30,0.571369886
Brandon Bass,101138,2016-17,577,52,21,11,10,1,5,29,5,14,15,1141,19.92094862,635,48,4,0.414937095
Blake Griffin,201933,2016-17,2076,61,300,125,83,42,108,142,58,51,91,4155,28.01890847,3424,557,18,0.660697975
Wesley Johnson,202325,2016-17,810,68,23,9,7,2,7,18,9,6,12,1620,12.62626263,984,38,5,0.225628085
Paul Pierce,1718,2016-17,277,25,10,6,3,3,2,16,5,7,9,553,15.08196721,316,19,1,0.279166667
Nick Young,201156,2016-17,1556,60,58,20,12,8,19,36,9,15,21,3185,19.44137168,1165,123,12,0.329264258
D'Angelo Russell,1626156,2016-17,1811,63,303,108,68,40,125,176,80,62,114,3718,26.76022835,3122,614,29,0.75544248
Corey Brewer,201147,2016-17,1281,82,97,35,26,9,42,55,14,27,28,2602,14.65897523,948,180,6,0.62117277
Jordan Clarkson,203903,2016-17,2397,82,213,51,35,16,112,164,65,66,98,4927,23.20599786,2397,473,29,0.627397882
Larry Nance Jr.,1626204,2016-17,1442,63,96,27,17,10,42,56,26,23,33,2962,13.54415274,1795,186,13,0.421596782
Luol Deng,2736,2016-17,1486,56,74,31,21,10,29,43,21,14,29,3021,14.44444444,1553,177,8,0.485755941
David Nwaba,1628021,2016-17,397,20,14,5,5,0,6,11,5,2,9,809,12.01764057,235,33,4,0.17965368
Tyler Ennis,203898,2016-17,588,53,86,28,20,8,40,45,26,15,30,1204,19.20821114,1007,149,7,0.63650773
Brandon Ingram,1627742,2016-17,2279,79,166,54,41,13,70,116,44,50,66,4637,16.94754781,2562,329,16,0.496776309
Thomas Robinson,203080,2016-17,560,48,31,14,9,5,10,46,13,23,23,1131,20.60836502,828,76,3,0.501695274
Timofey Mozgov,202389,2016-17,1104,54,43,19,14,5,11,72,15,45,27,2226,17.14623571,1065,101,3,0.425662273
Tarik Black,204028,2016-17,1091,67,39,19,13,6,10,58,10,35,23,2211,15.5226209,1319,115,6,0.470667648
Julius Randle,203944,2016-17,2132,74,264,139,108,31,63,173,45,89,84,4372,21.53225806,2985,541,19,0.704960347
Metta World Peace,1897,2016-17,160,25,11,0,0,0,5,7,3,3,4,317,22.86501377,116,20,1,-0.069264069
Ivica Zubac,1627826,2016-17,609,38,30,11,7,4,9,30,10,12,18,1273,20.50919378,840,52,4,0.280623974
JaMychal Green,203210,2016-17,2101,77,84,31,27,4,36,94,35,47,47,3981,14.73637767,2546,172,17,0.447041778
Jarell Martin,1626185,2016-17,558,42,8,3,1,2,3,28,7,16,12,1091,16.1752988,733,27,3,0.359031546
Wade Baldwin IV,1627735,2016-17,405,33,61,28,17,11,18,39,12,19,20,792,19.26091825,703,131,10,0.249824856
Andrew Harrison,1626150,2016-17,1474,72,198,85,64,21,53,85,30,40,45,2813,16.58929124,2526,488,34,0.711428504
Wayne Selden,1627782,2016-17,236,14,13,3,3,0,5,12,1,7,5,450,16.46090535,159,26,2,0.143162393
James Ennis III,203516,2016-17,1501,64,64,23,12,11,26,59,17,25,34,2895,13.01059002,1118,142,6,0.461817391
Tony Allen,2754,2016-17,1914,71,98,24,18,6,41,100,35,45,55,3611,18.1555502,1707,179,19,0.344982392
Mike Conley,201144,2016-17,2292,69,433,144,109,35,142,156,74,51,105,4392,26.13908873,4217,960,88,0.749313931
Vince Carter,1713,2016-17,1800,73,133,39,28,11,53,50,23,22,28,3441,15.04312532,1852,238,20,0.432461265
Deyonta Davis,1627738,2016-17,238,36,2,0,0,0,1,8,1,6,2,461,11.65413534,203,10,1,0.083333333
Chandler Parsons,202718,2016-17,675,34,55,23,12,11,14,24,10,11,13,1293,18.57541899,707,122,10,0.512139238
Troy Daniels,203584,2016-17,1183,67,46,14,11,3,17,45,14,22,23,2323,20.90332214,975,107,5,0.370400943
Marc Gasol,201188,2016-17,2531,74,338,127,90,37,139,166,45,70,96,4829,26.70920693,3915,718,20,0.72795736
Brandan Wright,201148,2016-17,447,28,15,6,5,1,6,10,2,4,6,849,16.63201663,407,33,1,0.266666667
Zach Randolph,2216,2016-17,1786,73,122,48,40,8,50,99,25,46,53,3406,28.80080281,2094,265,10,0.56642249
Josh Richardson,1626196,2016-17,1614,53,140,58,42,16,44,65,22,31,34,3174,16.84587814,1987,301,23,0.558856956
Chris Bosh,2547,2016-17,0,0,0,0,0,0,0,0,0,0,0,0,0,0,0,0,0
Wayne Ellington,201961,2016-17,1500,62,70,34,23,11,19,30,13,11,19,2946,17.80821918,1046,139,14,0.438252269
Josh McRoberts,201177,2016-17,381,22,50,12,10,2,19,23,8,9,14,716,17.59708738,728,117,3,0.083768116
Luke Babbitt,202337,2016-17,1065,68,36,16,14,2,10,25,10,13,12,2065,13.45657782,1448,96,4,0.385328077
Goran Dragic,201609,2016-17,2459,73,423,183,111,72,129,212,86,82,130,4869,26.66546633,4288,887,64,0.767424885
Tyler Johnson,204020,2016-17,2177,73,233,93,54,39,85,90,40,34,56,4324,20.78185133,2987,514,39,0.631391497
Dion Waiters,203079,2016-17,1384,46,200,99,65,34,63,103,36,49,54,2750,26.39381244,1711,383,29,0.802489193
Okaro White,1627855,2016-17,471,35,21,14,9,5,5,18,3,13,5,906,10.98376313,567,48,4,0.478835979
James Johnson,201949,2016-17,2085,76,276,112,65,47,109,171,64,80,91,4172,21.8895966,3276,604,21,0.764062824
Rodney McGruder,203585,2016-17,1966,78,124,48,29,19,47,56,19,25,31,3836,12.51999086,1483,256,13,0.551108583
Justise Winslow,1626159,2016-17,625,18,66,21,10,11,25,33,11,15,18,1231,20.08639309,843,140,10,0.571891729
Hassan Whiteside,202355,2016-17,2513,77,57,14,12,2,28,155,27,84,71,4925,22.66690278,1559,133,6,0.389056488
Willie Reed,203186,2016-17,1031,71,26,9,8,1,6,31,7,18,13,2034,15.51499348,654,93,3,0.336210318
Udonis Haslem,2617,2016-17,130,16,6,1,1,0,0,8,1,6,2,258,13.38028169,111,16,0,-0.25
Spencer Hawes,201150,2016-17,797,54,81,18,15,3,40,49,18,25,24,1615,19.68325792,964,161,11,0.58847072
Gary Payton II,1627780,2016-17,99,6,13,7,5,2,4,10,4,3,7,195,16.19047619,156,27,0,0.279487179
Jason Terry,1891,2016-17,1365,74,98,35,24,11,53,36,18,16,20,2639,9.834403515,1299,189,14,0.663398739
Thon Maker,1627748,2016-17,562,57,23,7,4,3,13,17,8,7,10,1073,18.51225697,654,41,4,0.475798321
Matthew Dellavedova,203521,2016-17,1986,76,357,95,69,26,184,133,77,46,87,3924,16,3267,712,39,0.806580671
Michael Beasley,201563,2016-17,935,56,53,16,12,4,25,66,15,32,34,1847,24.84382508,1022,116,11,0.506101507
Jabari Parker,203953,2016-17,1728,51,142,52,30,22,62,93,26,44,49,3458,26.02704108,2200,310,20,0.614163567
Malcolm Brogdon,1627763,2016-17,1982,75,317,103,66,37,143,113,54,36,77,3866,18.53308653,3343,625,35,0.717849125
Greg Monroe,202328,2016-17,1823,81,187,57,36,21,99,140,39,58,82,3589,24.16291854,1547,315,18,0.682065181
Rashad Vaughn,1626173,2016-17,459,41,23,4,2,2,12,14,5,4,10,907,17.09741551,283,32,3,0.124223602
Tony Snell,203503,2016-17,2336,80,96,29,19,10,42,55,22,23,32,4582,12.23205506,1478,192,23,0.424407664
Khris Middleton,203114,2016-17,889,29,99,26,15,11,64,65,36,21,44,1712,23.04417243,1097,204,12,0.76554958
John Henson,203089,2016-17,1123,58,57,19,13,6,22,52,7,33,19,2190,16.5993538,934,111,3,0.48185611
Giannis Antetokounmpo,203507,2016-17,2845,80,434,192,144,48,151,234,58,128,106,5561,28.44952504,4629,854,55,0.790656934
Mirza Teletovic,203141,2016-17,1133,70,48,18,12,6,18,37,12,20,17,2218,19.25415484,1299,96,11,0.422147319
Tyus Jones,1626145,2016-17,774,60,156,46,35,11,75,38,19,12,26,1534,13.5042735,1242,270,18,0.780466031
Kris Dunn,1627739,2016-17,1333,78,188,64,45,19,72,89,35,34,55,2572,14.3334447,2194,358,16,0.615817842
Brandon Rush,201575,2016-17,1030,47,45,10,6,4,16,28,9,16,12,2022,9.820254274,659,73,3,0.283234988
Gorgui Dieng,203476,2016-17,2653,82,158,55,36,19,61,107,30,58,49,5198,14.23265237,3096,299,17,0.457474735
Zach LaVine,203897,2016-17,1749,47,139,29,26,3,50,85,34,31,54,3413,21.72915073,1778,286,26,0.34762419
Ricky Rubio,201937,2016-17,2469,75,682,149,85,64,322,195,120,58,137,4879,17.37563086,4961,1191,49,0.845548565
Nikola Pekovic,201593,2016-17,0,0,0,0,0,0,0,0,0,0,0,0,0,0,0,0,0
Shabazz Muhammad,203498,2016-17,1516,78,35,10,8,2,12,56,10,35,21,2970,21.45772595,681,78,5,0.336226728
Omri Casspi,201956,2016-17,642,36,37,13,9,4,17,29,5,15,14,1265,14.11925977,878,64,7,0.489139349
Andrew Wiggins,203952,2016-17,3048,82,189,63,34,29,61,187,56,67,120,6036,28.99854862,2097,423,39,0.449343845
Jordan Hill,201941,2016-17,47,7,0,0,0,0,0,4,0,1,3,90,17.47572816,38,2,0,0
Karl-Anthony Towns,1626157,2016-17,3030,82,220,67,55,12,83,211,60,111,100,5964,27.48058039,3744,451,31,0.459811252
Adreian Payne,203940,2016-17,135,18,7,1,1,0,5,8,4,3,5,266,22.68370607,213,21,0,0.31547619
Cole Aldrich,202332,2016-17,531,62,25,9,6,3,6,17,1,12,5,1041,9.403862301,598,57,5,0.37128981
Nemanja Bjelica,202357,2016-17,1190,65,79,24,14,10,36,59,18,27,32,2325,16.43682445,1717,173,14,0.491504663
DeMarcus Cousins,202326,2016-17,2465,72,332,134,77,57,129,269,70,119,150,4857,36.51261278,3528,620,23,0.700219995
Tim Frazier,204025,2016-17,1525,65,335,98,76,22,108,101,53,31,70,3090,16.47710703,2999,639,38,0.682656355
Omer Asik,201600,2016-17,482,31,15,8,4,4,2,14,4,7,7,971,8.831646734,586,25,1,0.166666667
Jordan Crawford,202348,2016-17,442,19,57,14,10,4,33,25,10,11,14,888,25.84963955,503,88,12,0.304561404
Axel Toupane,1626253,2016-17,47,4,0,0,0,0,0,0,0,0,0,94,8.653846154,33,3,0,0
Jrue Holiday,201950,2016-17,2190,67,488,171,125,46,183,194,87,61,133,4461,23.58069749,4122,968,33,0.840400756
Donatas Motiejunas,202700,2016-17,479,34,32,10,7,3,8,30,10,11,19,985,17.26027397,748,77,2,0.018055556
Cheick Diallo,1627767,2016-17,199,17,4,2,2,0,1,7,0,3,4,406,20.39473684,202,8,2,0.226190476
Quincy Pondexter,202347,2016-17,0,0,0,0,0,0,0,0,0,0,0,0,0,0,0,0,0
Quinn Cook,1626188,2016-17,187,14,26,8,7,1,11,13,7,3,10,368,19.9017199,359,51,3,0.141025641
Anthony Davis,203076,2016-17,2708,75,157,64,38,26,70,181,35,89,92,5500,32.5428195,3469,332,21,0.569045272
Dante Cunningham,201967,2016-17,1649,66,37,16,13,3,11,28,13,13,15,3320,10.91655267,1376,87,4,0.33381096
Alexis Ajinca,201582,2016-17,584,39,12,3,2,1,5,31,4,19,12,1181,17.14939024,719,33,2,0.306705004
Solomon Hill,203524,2016-17,2374,80,141,43,31,12,63,82,40,29,53,4846,11.5917603,2094,303,21,0.47532439
E'Twaun Moore,202734,2016-17,1820,73,164,50,35,15,60,62,28,26,36,3689,17.46692798,1587,326,15,0.528389896
Maurice Ndour,1626254,2016-17,331,32,8,1,1,0,5,12,7,3,9,656,14.58885942,370,33,1,0.166666667
Chasson Randle,1626184,2016-17,299,26,34,10,8,2,12,19,8,9,10,601,19.67930029,543,84,5,0.138286894
Courtney Lee,201584,2016-17,2459,77,179,60,39,21,58,69,29,28,41,4884,14.56692913,2377,373,24,0.436425077
Kristaps Porzingis,204001,2016-17,2164,66,97,39,27,12,24,118,30,55,63,4345,24.51417004,2710,225,20,0.325185053
Carmelo Anthony,2546,2016-17,2538,74,213,73,42,31,75,153,51,72,81,5064,29.03612395,2623,447,22,0.531570245
Justin Holiday,203200,2016-17,1639,82,102,25,15,10,49,66,33,24,42,3249,17.00426439,1600,213,22,0.443117942
Kyle O'Quinn,203124,2016-17,1229,79,117,25,21,4,62,76,24,40,36,2415,18.62535613,1852,223,15,0.554220373
Joakim Noah,201149,2016-17,1015,46,103,26,20,6,42,58,22,30,28,2011,12.63877028,1874,223,6,0.504642533
Willy Hernangomez,1626195,2016-17,1324,72,96,37,25,12,27,100,34,43,57,2657,20.28132156,2102,198,13,0.387076165
Sasha Vujacic,2756,2016-17,408,42,52,14,10,4,21,16,8,6,10,816,17.11229947,581,105,4,0.131410256
Derrick Rose,201565,2016-17,2082,64,283,114,76,38,81,147,61,55,92,4183,25.73866001,3651,638,44,0.628278587
Ron Baker,1627758,2016-17,857,52,107,34,25,9,45,56,31,15,41,1672,15.23560209,1408,227,12,0.587035875
Marshall Plumlee,1627850,2016-17,170,21,10,5,3,2,1,12,3,3,9,336,12.40694789,175,26,1,0.016666667
Lance Thomas,202498,2016-17,968,46,35,10,5,5,10,25,6,16,9,1909,13.36384439,1044,90,10,0.297277341
Mindaugas Kuzminskas,1627851,2016-17,1016,68,69,25,17,8,26,51,11,29,22,2040,18.973496,1119,143,3,0.530546955
Russell Westbrook,201566,2016-17,2802,81,840,206,130,76,471,438,238,136,302,5784,40.7688869,4645,1693,67,1.211475686
Domantas Sabonis,1627734,2016-17,1631,81,82,39,21,18,25,83,17,49,34,3265,15.8768407,2069,169,9,0.495907671
Nick Collison,2555,2016-17,128,20,12,2,1,1,10,4,2,2,2,253,9.933774834,222,33,0,0.5
Victor Oladipo,203506,2016-17,2223,67,176,49,30,19,80,119,40,51,68,4532,21.32212457,1903,354,16,0.554411357
Semaj Christon,203902,2016-17,973,64,130,45,31,14,49,43,18,19,24,1886,12.75045537,1690,298,21,0.686297709
Alex Abrines,203518,2016-17,1055,68,40,14,10,4,16,33,14,14,19,2172,15.6200318,844,93,2,0.423088707
Jerami Grant,203924,2016-17,1531,80,46,19,12,7,17,44,11,23,21,3091,12.44369369,1408,130,6,0.467425821
Enes Kanter,202683,2016-17,1533,72,67,35,27,8,24,123,20,63,60,3082,27.68282432,1340,182,10,0.639204412
Steven Adams,203500,2016-17,2389,80,86,45,40,5,33,146,25,75,71,4878,16.06954689,1891,240,9,0.638920373
Kyle Singler,202713,2016-17,385,32,9,2,2,0,4,11,3,6,5,775,11.34593993,285,26,2,0.181818182
Andre Roberson,203460,2016-17,2376,79,79,32,17,15,29,51,20,14,37,4828,10.10533833,1973,199,12,0.381604341
Taj Gibson,201959,2016-17,1989,78,73,18,8,10,32,105,21,58,47,3945,19.05790838,2906,157,15,0.335352115
Doug McDermott,203926,2016-17,1508,66,58,20,17,3,19,38,10,20,18,2991,16.45459803,1034,120,14,0.376815478
Norris Cole,202708,2016-17,125,13,14,1,1,0,7,7,4,2,5,252,22.06896552,186,32,1,0
Josh Huestis,203962,2016-17,31,2,3,3,2,1,0,0,0,0,0,67,14.1025641,28,3,1,0
Aaron Gordon,203932,2016-17,2298,80,150,52,42,10,58,89,31,36,53,4598,20.09202454,1977,319,28,0.501670079
Damjan Rudez,204014,2016-17,314,45,20,4,4,0,12,9,6,3,6,623,13.81766382,401,53,1,0.244444444
Elfrid Payton,203901,2016-17,2412,82,529,148,118,30,196,178,76,66,112,4861,21.44153958,4462,1138,70,0.834062603
Mario Hezonja,1626209,2016-17,960,65,62,19,14,5,29,58,24,22,36,1891,19.1588785,824,125,6,0.515871026
Nikola Vucevic,202696,2016-17,2163,75,208,94,77,17,68,117,36,59,58,4400,24.51807229,3572,475,23,0.632851783
Evan Fournier,203095,2016-17,2234,68,202,56,41,15,66,140,46,51,89,4493,23.2051785,1891,445,29,0.493241796
Bismack Biyombo,202687,2016-17,1793,81,74,26,24,2,19,95,19,60,35,3464,13.77382465,2477,172,12,0.317335206
Marcus Georges-Hunt,1627875,2016-17,48,5,3,2,2,0,0,2,1,1,1,97,12.72727273,38,7,1,0.166666667
D.J. Augustin,201571,2016-17,1538,78,209,65,55,10,74,90,45,32,58,3010,20.02366164,2552,463,32,0.599390267
Jodie Meeks,201975,2016-17,738,36,45,21,15,6,19,36,17,10,26,1477,19.74483597,530,100,10,0.638995415
Patricio Garino,1627868,2016-17,43,5,0,0,0,0,0,3,0,3,0,87,10.20408163,31,5,0,0
Terrence Ross,203082,2016-17,1932,77,88,31,23,8,38,68,27,25,43,3953,18.89163114,1280,179,10,0.472467116
C.J. Watson,201228,2016-17,1013,62,114,49,40,9,26,47,25,14,33,2020,14.16007036,1262,266,9,0.563881773
Stephen Zimmerman,1627757,2016-17,108,19,4,1,1,0,2,3,1,2,1,211,14.51612903,147,9,0,0.305555556
Jeff Green,201145,2016-17,1534,69,81,30,25,5,28,75,25,27,48,3030,20.52478134,1508,202,8,0.435016848
Jerryd Bayless,201573,2016-17,71,3,13,6,5,1,5,9,3,3,6,140,28.93081761,152,20,1,0.290598291
T.J. McConnell,204456,2016-17,2133,81,534,204,168,36,240,160,75,61,99,4414,14.48598131,5600,1148,53,1.035086436
Alex Poythress,1627816,2016-17,157,6,5,2,2,0,1,3,0,1,2,316,16.66666667,253,13,0,0.044444444
Jahlil Okafor,1626143,2016-17,1134,50,58,25,20,5,23,90,9,48,42,2267,24.77424421,1405,140,7,0.561798236
Dario Saric,203967,2016-17,2129,81,182,70,51,19,70,183,58,91,92,4377,24.4732577,3456,356,27,0.538543936
Nik Stauskas,203917,2016-17,2188,80,188,65,51,14,80,128,49,48,80,4442,16.4745628,2502,400,14,0.572297388
Gerald Henderson,201945,2016-17,0,0,0,0,0,0,0,0,0,0,0,0,0,0,0,0,0
Sergio Rodriguez,200771,2016-17,1517,68,344,104,85,19,180,128,67,42,86,3061,19.27607009,3602,724,42,0.946546919
Timothe Luwawu-Cabarrot,1627789,2016-17,1190,69,75,18,13,5,37,73,25,30,43,2473,17.8584392,1065,134,9,0.442079606
Joel Embiid,203954,2016-17,786,31,66,32,28,4,24,117,15,63,54,1598,36.5,1267,148,7,0.666411892
Richaun Holmes,1626158,2016-17,1193,57,58,30,24,6,24,55,11,31,24,2439,18.73854052,1451,100,7,0.604986888
Justin Anderson,1626147,2016-17,1225,74,66,24,17,7,30,66,16,37,29,2426,20.68206821,1475,158,9,0.574482074
Ben Simmons,1627732,2016-17,0,0,0,0,0,0,0,0,0,0,0,0,0,0,0,0,0
Robert Covington,203496,2016-17,2119,67,102,44,26,18,37,131,32,76,55,4353,19.11047929,2311,206,13,0.507189773
Shawn Long,1627848,2016-17,234,18,13,4,2,2,6,13,0,8,5,478,24.59605027,290,27,1,0.307692308
Tiago Splitter,201168,2016-17,76,8,4,0,0,0,2,6,1,2,4,154,22.22222222,103,11,0,-0.055555556
Marquese Chriss,1627737,2016-17,1705,80,60,6,6,0,29,108,26,57,51,3646,19.75012013,1986,141,5,0.246287519
Devin Booker,1626164,2016-17,2656,76,268,94,61,33,119,241,94,91,150,5720,28.36846929,2442,579,30,0.709071631
Eric Bledsoe,202339,2016-17,2110,64,418,141,84,57,180,224,86,91,133,4540,27.88813886,4036,859,32,0.856636078
Jared Dudley,201162,2016-17,1362,64,121,27,21,6,52,73,33,28,45,2844,13.83570105,2480,236,11,0.382515663
Tyson Chandler,2199,2016-17,1229,45,30,11,8,3,10,65,18,44,21,2676,11.44538914,1433,86,7,0.388963906
Tyler Ulis,1627755,2016-17,1103,59,226,53,34,19,112,77,37,26,51,2351,20.34213462,2003,472,22,0.839546316
Derrick Jones Jr.,1627884,2016-17,545,32,12,6,6,0,0,13,4,6,7,1136,11.84210526,349,31,5,0.132885436
Brandon Knight,202688,2016-17,1121,53,130,54,40,14,44,88,36,31,57,2359,25.45657846,1650,290,14,0.639058897
TJ Warren,203933,2016-17,1994,64,75,21,10,11,43,57,20,27,30,4292,19.06211937,1638,191,11,0.556954382
Ronnie Price,101179,2016-17,134,14,18,5,3,2,6,3,1,1,2,278,8.761329305,205,43,0,0.055555556
Alan Williams,1626210,2016-17,708,47,23,8,8,0,8,37,4,30,7,1476,20.64327485,708,55,5,0.454623009
Leandro Barbosa,2571,2016-17,940,65,81,22,14,8,40,48,21,16,32,1963,20.64923354,911,158,8,0.551397434
Alex Len,203458,2016-17,1528,75,44,11,9,2,21,102,24,62,40,3244,17.66917293,1486,116,7,0.417198581
Elijah Millsap,202407,2016-17,23,2,1,1,0,1,0,2,1,1,1,44,19.60784314,26,3,0,0.5
Dragan Bender,1627733,2016-17,545,41,23,3,1,2,15,32,10,15,17,1166,14.8455162,651,40,4,0.407030457
Damian Lillard,203081,2016-17,2693,75,440,159,113,46,183,197,99,60,137,5438,30.80530401,4359,892,55,0.747992106
Evan Turner,202323,2016-17,1659,65,205,67,54,13,86,100,51,36,64,3329,18.67275658,2090,435,12,0.670014916
CJ McCollum,203468,2016-17,2796,80,285,122,86,36,94,172,70,57,115,5618,27.43488556,3174,634,49,0.628193642
Maurice Harkless,203090,2016-17,2223,77,88,41,32,9,23,86,22,42,44,4446,15.1984127,1767,188,18,0.414362178
Pat Connaughton,1626192,2016-17,316,39,28,14,10,4,7,17,9,7,10,637,13.03116147,309,59,4,0.220588235
Shabazz Napier,203894,2016-17,512,53,67,31,23,8,24,41,14,15,26,1004,22.11101001,824,139,6,0.716353771
Al-Farouq Aminu,202329,2016-17,1773,61,99,41,34,7,41,94,31,44,50,3520,15.86612161,1824,186,7,0.524525152
Jake Layman,1627774,2016-17,249,35,11,6,6,0,2,11,1,6,5,512,19.04761905,189,18,2,0.242424242
Meyers Leonard,203086,2016-17,1222,74,71,36,29,7,18,35,14,13,22,2481,15.88235294,1478,160,6,0.456893532
Ed Davis,202334,2016-17,789,46,26,10,8,2,10,37,6,20,17,1563,12.11111111,857,74,8,0.462881614
Noah Vonleh,203943,2016-17,1265,74,31,18,15,3,8,65,9,42,23,2506,13.21678322,1324,85,3,0.518820698
Allen Crabbe,203459,2016-17,2254,79,94,40,28,12,26,62,15,32,30,4567,14.92830485,1641,191,15,0.40863469
Jusuf Nurkic,203994,2016-17,1383,64,123,32,24,8,69,143,35,77,66,2818,23.66646229,1990,218,2,0.601134807
Festus Ezeli,203105,2016-17,0,0,0,0,0,0,0,0,0,0,0,0,0,0,0,0,0
Tim Quarterman,1627817,2016-17,80,16,11,4,2,2,2,11,8,2,9,166,22.77777778,99,22,0,-0.060606061
Willie Cauley-Stein,1626161,2016-17,1421,75,80,22,14,8,33,69,17,34,35,2774,20.08463542,1407,163,6,0.415641818
Skal Labissiere,1627746,2016-17,612,33,27,7,7,0,9,37,11,12,25,1221,21.31268437,685,57,3,0.210382968
Malachi Richardson,1627781,2016-17,198,22,11,5,3,2,5,8,1,6,2,390,19.58041958,165,19,0,0.492424242
Darren Collison,201954,2016-17,2063,68,312,130,110,20,115,114,56,42,72,4034,19.87965233,4086,681,51,0.738165221
Rudy Gay,200752,2016-17,1013,30,83,24,18,6,39,74,28,25,49,2008,25.09872751,1078,173,10,0.536244327
Langston Galloway,204038,2016-17,1494,74,93,39,31,8,25,46,23,15,31,3002,18.47401622,1529,192,11,0.384287354
Ty Lawson,201951,2016-17,1732,69,334,112,76,36,144,129,77,40,89,3441,19.46396045,3263,733,39,0.851009636
Georgios Papagiannis,1627834,2016-17,355,22,20,5,5,0,6,24,5,11,13,702,17.076326,394,38,3,0.036111111
Garrett Temple,202066,2016-17,1728,65,168,47,30,17,78,78,40,28,50,3409,14.2554319,2028,319,14,0.538943384
Ben McLemore,203463,2016-17,1176,61,51,16,12,4,21,62,19,29,33,2317,20.12432012,1061,120,7,0.429879172
Buddy Hield,1627741,2016-17,1888,82,121,46,35,11,38,101,38,35,66,3807,21.33682207,1731,239,25,0.407719223
Tyreke Evans,201936,2016-17,788,40,124,53,38,15,37,61,24,29,32,1559,27.02078522,1235,282,8,0.803817832
Arron Afflalo,201167,2016-17,1580,61,78,29,22,7,20,42,13,23,19,3085,14.60345332,1511,189,12,0.388781124
Kosta Koufos,201585,2016-17,1419,71,47,17,12,5,12,61,13,30,31,2749,15.46158812,1546,122,8,0.2791784
Kyle Anderson,203937,2016-17,1011,71,91,33,26,7,35,39,9,23,16,2018,12.15201061,1176,158,17,0.567801929
Kawhi Leonard,202695,2016-17,2442,73,260,124,73,51,72,154,44,70,84,4815,31.16022099,2382,514,36,0.664962904
Dewayne Dedmon,203473,2016-17,1316,75,44,11,8,3,17,61,14,39,22,2560,12.15619694,1389,94,5,0.321914881
Dejounte Murray,1627749,2016-17,322,38,48,11,7,4,23,38,16,13,25,635,23.69534556,554,80,1,0.155701754
Patty Mills,201988,2016-17,1754,80,280,77,51,26,103,101,51,38,63,3520,18.92095358,3258,502,54,0.541888241
Tony Parker,2225,2016-17,1556,62,285,69,45,24,69,89,41,34,55,3011,20.81620669,2922,546,39,0.482642743
David Lee,101135,2016-17,1464,78,124,48,33,15,44,82,26,43,39,2938,16.58109333,2081,228,10,0.51536598
Bryn Forbes,1627854,2016-17,280,35,23,7,7,0,7,11,4,5,6,563,17.7496038,311,44,4,0.093544137
LaMarcus Aldridge,200746,2016-17,2302,71,139,67,48,19,32,98,25,45,53,4468,25.15313179,2509,290,26,0.440186083
Danny Green,201980,2016-17,1778,67,124,22,12,10,51,76,43,28,48,3441,13.8213463,2037,221,16,0.277639873
Pau Gasol,2200,2016-17,1599,63,150,37,25,12,75,81,35,23,58,3163,21.77236693,2623,272,9,0.448454578
Jonathon Simmons,203613,2016-17,1376,77,126,63,44,19,33,76,22,31,45,2742,18.06181584,1475,262,22,0.599237103
Manu Ginobili,1938,2016-17,1266,68,183,63,39,24,68,96,53,26,70,2639,19.48924731,1537,308,23,0.583134416
Joel Anthony,201202,2016-17,122,19,3,1,0,1,1,4,2,2,2,247,8.759124088,97,6,1,0.166666667
Davis Bertans,202722,2016-17,803,66,46,18,10,8,20,32,12,15,17,1633,15.18780621,948,88,4,0.518086335
PJ Tucker,200782,2016-17,2180,79,99,32,21,11,33,66,22,37,29,4519,11.34574774,2363,208,10,0.360204219
DeMarre Carroll,201960,2016-17,1860,71,74,27,23,4,27,54,15,27,27,3682,15.66666667,1447,151,8,0.415266361
Cory Joseph,202709,2016-17,1977,79,265,111,71,40,76,108,46,46,62,3938,18.39106145,3186,578,32,0.654749891
Kyle Lowry,200768,2016-17,2210,59,417,106,64,42,196,174,74,67,107,4403,24.77486492,3555,803,43,0.775133907
Serge Ibaka,201586,2016-17,2422,79,75,31,25,6,23,105,32,42,63,4796,21.16490447,2689,215,22,0.355391652
DeMar DeRozan,201942,2016-17,2591,73,290,132,86,46,85,180,63,54,126,5203,34.20738975,2530,610,49,0.658146251
Jonas Valanciunas,202685,2016-17,2044,79,57,25,18,7,16,106,22,60,46,4040,19.63163597,2630,144,13,0.366513774
Bruno Caboclo,203998,2016-17,38,8,4,2,1,1,2,2,0,2,0,86,17.64705882,36,5,0,0.666666667
Fred VanVleet,1627832,2016-17,292,36,35,12,8,4,13,15,6,7,8,597,20.23809524,407,67,8,0.203174603
Norman Powell,1626181,2016-17,1341,75,82,36,25,11,27,70,25,32,38,2717,21.20915033,1047,186,9,0.570359859
Jakob Poeltl,1627751,2016-17,621,53,12,6,3,3,2,29,6,19,10,1219,12.05673759,538,32,4,0.329400149
Pascal Siakam,1627783,2016-17,832,54,17,6,4,2,9,33,10,15,18,1694,13.1292164,872,38,1,0.456452485
Patrick Patterson,202335,2016-17,1599,65,76,37,27,10,26,38,14,21,17,3153,12.58408072,1978,131,9,0.494645946
Delon Wright,1626153,2016-17,446,27,57,32,20,12,17,25,7,9,16,864,16.80080483,713,128,9,0.312982456
Lucas Nogueira,203512,2016-17,1067,56,42,25,15,10,12,46,8,31,15,2156,9.533635988,954,97,8,0.631509635
Joe Ingles,204060,2016-17,1972,82,225,68,37,31,125,107,52,39,68,3762,13.96396396,2310,447,23,0.73278636
George Hill,201588,2016-17,1544,49,204,83,47,36,77,85,43,25,60,2899,23.53121175,2721,406,31,0.627849492
Rodney Hood,203918,2016-17,1593,59,96,33,23,10,46,65,19,35,30,2999,23.22811197,1394,233,13,0.649146995
Joe Johnson,2207,2016-17,1843,78,144,61,32,29,59,69,22,24,45,3485,18.61182519,2000,266,20,0.559938593
Shelvin Mack,202714,2016-17,1205,55,154,67,45,22,52,90,37,36,54,2301,19.54334365,2218,333,21,0.665877744
Alec Burks,202692,2016-17,653,42,30,5,3,2,19,35,8,20,15,1266,21.875,625,78,10,0.568058222
Dante Exum,203957,2016-17,1228,66,111,34,23,11,55,80,34,31,49,2348,18.07458143,1590,221,14,0.583262939
Derrick Favors,202324,2016-17,1186,50,56,20,15,5,26,60,21,27,33,2225,21.06527833,1547,107,5,0.464147257
Gordon Hayward,202330,2016-17,2516,73,252,107,60,47,107,140,44,60,80,4774,27.39317037,2953,540,42,0.7228881
Joel Bolomboy,1627762,2016-17,53,12,2,1,0,1,1,2,1,1,1,108,17.64705882,57,6,0,0.5
Jeff Withey,203481,2016-17,432,51,7,4,3,1,1,14,3,9,5,849,14.50939457,505,21,1,0.261904762
Raul Neto,203526,2016-17,346,40,34,13,10,3,17,15,6,7,8,669,14.55273698,504,69,5,0.37124183
Rudy Gobert,203497,2016-17,2744,81,97,38,36,2,42,147,27,81,66,5173,16.88980433,3683,259,15,0.506459932
Boris Diaw,2564,2016-17,1283,73,170,62,47,15,86,87,38,35,52,2410,15.94202899,2009,366,12,0.805470276
Trey Lyles,1626168,2016-17,1158,71,69,37,28,9,24,64,21,32,32,2222,21.47704591,1705,142,8,0.589967644
Chris McCullough,1626191,2016-17,80,16,2,0,0,0,2,3,1,1,2,168,19.37172775,105,6,1,0.444444444
John Wall,202322,2016-17,2836,78,831,288,207,81,345,322,142,112,210,5824,30.2960928,4697,1589,78,1.109605449
Bradley Beal,203078,2016-17,2684,77,267,85,57,28,88,156,58,66,90,5472,26.19434514,2411,515,53,0.527781157
Markieff Morris,202693,2016-17,2374,76,126,36,24,12,54,129,43,66,63,4809,20.58714919,2061,238,16,0.433892345
Brandon Jennings,201943,2016-17,1801,81,395,128,96,32,159,128,52,48,80,3642,17.56367131,3569,828,38,0.876657957
Sheldon Mac,1627815,2016-17,287,30,15,3,3,0,5,5,1,2,3,568,14.28571429,255,32,4,2.78E-17
Kelly Oubre Jr.,1626162,2016-17,1605,79,47,17,15,2,11,50,13,23,27,3231,14.73742095,1122,85,5,0.211128425
Marcin Gortat,101162,2016-17,2556,82,121,55,40,15,38,119,30,67,52,5183,14.79391141,2939,273,27,0.489299694
Jason Smith,201160,2016-17,1068,74,37,12,11,1,13,58,19,33,25,2119,17.06299541,1447,76,3,0.32234769
Otto Porter Jr.,203490,2016-17,2605,80,121,33,20,13,47,44,21,17,27,5328,14.90745373,2277,229,17,0.311757033
Ian Mahinmi,101133,2016-17,555,31,19,8,7,1,6,34,4,25,9,1112,14.24025457,605,40,5,0.453461252
Tomas Satoransky,203107,2016-17,719,57,92,29,24,5,28,38,15,12,26,1398,12.68323773,930,184,3,0.511922158
Daniel Ochefu,1627849,2016-17,75,19,3,3,1,2,0,3,0,2,1,150,18.12865497,67,4,0,0.555555556
Trey Burke,203504,2016-17,703,57,100,31,24,7,25,48,19,21,27,1364,20.5613577,1143,206,11,0.51242401
Bojan Bogdanovic,202711,2016-17,2064,80,111,45,29,16,45,131,41,54,77,4351,22.402665,1688,236,33,0.535700236
Jeff Teague,201952,2015-16,2255,79,470,153,117,36,175,218,92,71,147,4599,26.33647799,4111,1003,61,0.828537289
Paul Millsap,200794,2015-16,2647,81,265,112,71,41,107,191,56,76,115,5357,24.15702063,3730,546,35,0.645035628
Tim Hardaway Jr.,203501,2015-16,864,51,51,19,14,5,17,23,8,11,12,1714,16.37612256,731,108,12,0.471378794
Tiago Splitter,201168,2015-16,579,36,30,7,5,2,14,24,6,12,12,1159,15.50925926,597,65,4,0.421140244
Kirk Hinrich,2550,2015-16,631,46,73,25,19,6,21,30,17,9,21,1232,11.72316384,923,131,16,0.413005787
Lamar Patterson,203934,2015-16,395,35,39,13,10,3,18,23,5,14,9,799,12.68237935,441,70,1,0.331103679
Al Horford,201143,2015-16,2631,82,263,101,66,35,105,107,38,48,59,5319,20.72210815,3908,561,29,0.622914604
Dennis Schroder,203471,2015-16,1621,80,349,136,115,21,133,183,82,66,117,3202,29.47160215,3188,719,74,0.893412163
Edy Tavares,204002,2015-16,73,11,3,1,1,0,2,5,1,2,3,149,17.07317073,71,4,0,0.466666667
Kent Bazemore,203145,2015-16,2083,75,171,38,30,8,85,138,54,55,83,4212,19.96561358,2555,303,24,0.449536093
Thabo Sefolosha,200757,2015-16,1758,75,107,38,30,8,49,68,23,32,36,3466,12.50973268,2086,205,23,0.518164183
Kyle Korver,2594,2015-16,2401,80,164,43,27,16,75,98,42,45,53,4917,13.36651917,1851,268,20,0.462313513
Mike Muscala,203488,2015-16,565,60,34,11,6,5,15,27,10,12,15,1121,15.69255404,837,69,6,0.450748534
Mike Scott,203118,2015-16,1146,75,78,27,17,10,38,42,13,21,21,2291,17.7029703,1320,128,8,0.541995875
Kris Humphries,2743,2015-16,835,53,36,10,6,4,13,38,11,19,19,1700,19.375,1199,74,8,0.289229742
Avery Bradley,202340,2015-16,2507,75,158,36,29,7,73,109,43,45,64,5172,19.93916864,1672,303,19,0.462903113
Isaiah Thomas,202738,2015-16,2610,81,509,172,118,54,188,220,74,84,136,5479,29.31778239,4832,1068,64,0.798097108
Jared Sullinger,203096,2015-16,1900,80,187,66,50,16,67,102,24,61,41,3888,21.93433103,2607,402,18,0.609688863
Jonas Jerebko,201973,2015-16,1160,77,62,18,16,2,24,52,12,29,23,2388,13.56673961,1614,139,10,0.402599148
Evan Turner,202323,2015-16,2244,80,359,99,75,24,183,169,84,49,120,4664,18.76053174,3238,712,21,0.752674969
Terry Rozier,1626179,2015-16,308,38,37,18,15,3,10,19,8,4,15,635,17.33870968,556,92,3,0.160265529
James Young,203923,2015-16,196,28,9,5,4,1,3,5,0,5,0,407,9.492273731,134,19,0,0.555555556
RJ Hunter,1626154,2015-16,307,35,13,1,1,0,7,11,6,2,9,646,15.38461538,226,42,0,0.009324009
John Holland,204066,2015-16,0,0,0,0,0,0,0,0,0,0,0,0,0,0,0,0,0
Marcus Smart,203935,2015-16,1667,61,185,58,39,19,92,80,38,33,47,3467,17.16511686,2016,387,19,0.705761999
Kelly Olynyk,203482,2015-16,1370,68,105,33,21,12,46,74,12,44,30,2895,20.81818182,2075,239,8,0.573545762
Tyler Zeller,203092,2015-16,698,59,29,6,4,2,11,46,9,25,21,1474,22.99880526,793,80,1,0.316195555
Jordan Mickey,1626175,2015-16,57,16,1,1,1,0,0,1,1,0,1,117,19.56521739,75,4,0,0.333333333
Amir Johnson,101161,2015-16,1777,78,138,46,38,8,43,94,30,46,48,3619,13.83029722,2536,243,22,0.373948953
Jae Crowder,203109,2015-16,2278,72,135,35,27,8,71,83,37,38,45,4751,18.35268104,2489,283,25,0.509061024
Shane Larkin,203499,2015-16,1751,78,342,87,51,36,116,146,73,43,103,3460,17.57269279,3493,773,41,0.687835865
Chris McCullough,1626191,2015-16,362,24,9,2,0,2,3,15,0,10,5,723,16.1097852,406,15,1,0.111111111
Jarrett Jack,101127,2015-16,1027,32,236,37,24,13,88,94,47,28,66,2052,21.21598639,2017,448,25,0.620619184
Sean Kilpatrick,203930,2015-16,616,31,29,12,9,3,11,31,10,9,22,1244,23.16305108,403,76,6,0.535173206
Sergey Karasev,203508,2015-16,399,40,35,11,5,6,14,22,13,4,18,812,12.03090508,369,63,5,0.108225108
Brook Lopez,201572,2015-16,2457,73,146,39,29,10,72,175,49,82,93,4868,27.58304276,2212,331,19,0.534153253
Henry Sims,203156,2015-16,263,14,9,1,0,1,5,12,3,8,4,531,17.08126036,217,15,1,0.222222222
Donald Sloan,202388,2015-16,1318,61,268,62,44,18,105,80,43,23,57,2608,16.56845754,2672,547,30,0.672039326
Wayne Ellington,201961,2015-16,1615,76,83,23,16,7,34,45,23,15,30,3185,17.59285116,1187,168,14,0.376749477
Markel Brown,203900,2015-16,982,62,91,20,13,7,45,54,26,15,39,1943,18.73315364,971,207,11,0.564188224
Rondae Hollis-Jefferson,1626178,2015-16,615,29,43,7,3,4,18,26,9,11,15,1229,13.25811001,638,98,4,0.368708932
Thaddeus Young,201152,2015-16,2407,73,136,41,20,21,55,136,36,58,78,4738,22.01834862,3437,292,25,0.387643199
Willie Reed,203186,2015-16,426,39,10,3,2,1,5,16,3,7,9,827,18.23899371,324,23,2,0.279166667
Thomas Robinson,203080,2015-16,917,71,46,10,6,4,25,69,12,38,31,1799,19.22348485,1242,83,3,0.435118016
Bojan Bogdanovic,202711,2015-16,2115,79,99,29,17,12,32,115,32,45,70,4177,19.46266131,1526,193,18,0.29765713
Spencer Hawes,201150,2015-16,1035,57,109,35,27,8,44,58,18,31,27,2054,17.27153476,1099,222,7,0.652759469
Courtney Lee,201584,2015-16,2334,79,136,43,27,16,34,72,29,30,42,4542,14.850702,2067,300,22,0.312071278
Marvin Williams,101107,2015-16,2338,81,110,50,39,11,30,62,20,33,29,4615,16.84782609,3682,231,12,0.399565453
Jeremy Lamb,203087,2015-16,1227,66,77,28,19,9,30,50,25,18,32,2442,21.90371187,1136,193,20,0.533768666
Nicolas Batum,201587,2015-16,2448,70,403,149,117,32,162,205,97,75,130,4866,21.22615299,3325,800,36,0.794395601
Jeremy Lin,202391,2015-16,2048,78,235,92,69,23,92,150,40,67,83,4071,22.26373626,2430,519,34,0.732199161
Aaron Harrison,1626151,2015-16,93,21,2,0,0,0,1,4,0,4,0,203,13.42592593,56,5,0,0.166666667
Jorge Gutierrez,203268,2015-16,63,12,17,8,5,3,2,6,3,1,5,133,15.06849315,100,27,1,-0.022875817
Michael Kidd-Gilchrist,203077,2015-16,205,7,9,6,4,2,2,8,1,7,1,399,17.7383592,128,24,2,0.513888889
Kemba Walker,202689,2015-16,2885,81,421,195,160,35,135,171,70,54,117,5725,26.57156294,5228,970,80,0.744205713
Al Jefferson,2744,2015-16,1096,47,70,24,22,2,30,34,6,15,19,2164,24.63281578,725,143,8,0.57953656
Troy Daniels,203584,2015-16,476,43,21,6,3,3,6,24,8,9,15,967,19.98141264,372,44,2,0.029761905
Cody Zeller,203469,2015-16,1774,73,71,31,20,11,19,68,11,41,27,3526,15.55498982,1286,182,12,0.482656194
Frank Kaminsky,1626163,2015-16,1708,81,98,51,41,10,25,58,11,30,28,3384,17.11568938,2774,201,11,0.471397373
Tyler Hansbrough,201946,2015-16,343,44,8,4,3,1,3,12,2,8,4,682,14.63414634,168,20,3,0.430555556
Aaron Brooks,201166,2015-16,1108,69,180,69,50,19,55,82,35,34,48,2181,23.15705128,1757,369,17,0.70348317
Derrick Rose,201565,2015-16,2097,66,311,91,54,37,93,175,72,67,108,4207,27.0625,3576,635,49,0.532978502
Doug McDermott,203926,2015-16,1861,81,59,22,19,3,19,53,17,22,31,3772,16.93811075,1181,117,17,0.328551378
Bobby Portis,1626171,2015-16,1102,62,52,24,21,3,16,54,15,25,29,2170,20.80832333,1431,113,7,0.438391683
Cristiano Felicio,1626245,2015-16,321,31,26,12,10,2,11,13,2,6,7,639,13.77899045,502,49,3,0.371794872
Justin Holiday,203200,2015-16,773,53,56,14,11,3,26,39,19,14,25,1547,16.40670133,601,96,5,0.451202406
Spencer Dinwiddie,203915,2015-16,159,12,22,6,5,1,8,7,4,3,4,310,21.16991643,298,65,5,0.112554113
Joakim Noah,201149,2015-16,635,29,110,37,33,4,38,52,19,28,24,1246,14.06143345,1294,200,7,0.66415883
Pau Gasol,2200,2015-16,2291,72,294,81,64,17,160,164,81,47,117,4598,24.7313891,4037,587,21,0.650214675
Tony Snell,203503,2015-16,1301,64,63,12,5,7,20,52,18,26,26,2600,13.70695476,866,143,12,0.282978978
Jimmy Butler,202710,2015-16,2474,67,321,103,72,31,83,132,54,45,87,4908,24.60686204,3029,670,44,0.518420555
Taj Gibson,201959,2015-16,1936,73,106,32,28,4,33,78,14,46,32,3772,14.77115118,1922,210,18,0.360854338
Mike Dunleavy,2399,2015-16,703,31,39,11,6,5,14,26,17,7,19,1393,14.38485804,676,98,12,0.348475539
Cameron Bairstow,203946,2015-16,103,18,6,1,0,1,5,4,1,2,2,221,19.67213115,149,14,1,0.5
Nikola Mirotic,202703,2015-16,1646,66,100,26,17,9,52,102,33,45,57,3317,21.25267666,2173,190,17,0.463260229
E'Twaun Moore,202734,2015-16,1263,59,99,27,20,7,38,53,17,22,31,2515,16.00700525,1453,216,31,0.447943097
Kevin Love,201567,2015-16,2424,77,185,68,48,20,87,142,62,52,90,4660,23.70148134,3398,324,33,0.522250471
James Jones,2592,2015-16,463,48,14,6,3,3,5,13,4,7,6,922,15.79961464,550,37,2,0.298534799
Kyrie Irving,202681,2015-16,1667,53,250,100,65,35,79,124,43,43,81,3216,29.11358092,2721,465,43,0.614761996
Iman Shumpert,202697,2015-16,1316,54,92,47,38,9,32,57,19,27,30,2550,13.33102493,1087,180,11,0.652295214
JR Smith,2747,2015-16,2362,77,130,51,32,19,50,59,18,30,29,4587,17.93602437,1818,230,27,0.503635693
Matthew Dellavedova,203521,2015-16,1867,76,337,114,78,36,168,116,59,41,75,3605,15.88035019,3273,640,58,0.826279867
Channing Frye,101112,2015-16,1177,69,71,22,18,4,27,43,14,24,19,2296,15.6009245,1636,130,4,0.39943309
Jordan McRae,203895,2015-16,196,22,25,9,3,6,13,15,7,6,9,378,24.76415094,267,52,6,0.346666667
Tristan Thompson,202684,2015-16,2269,82,62,38,30,8,14,61,10,35,26,4373,11.67955582,2273,132,13,0.47954828
Sasha Kaun,201619,2015-16,95,25,3,1,1,0,1,7,1,5,2,203,12.60869565,84,8,1,0.238095238
Timofey Mozgov,202389,2015-16,1326,76,33,13,9,4,8,71,13,38,33,2553,16.40488656,1275,81,2,0.27271611
LeBron James,2544,2015-16,2709,76,514,240,145,95,164,249,105,106,143,5253,31.06893107,3850,1034,69,0.911488578
Richard Jefferson,2210,2015-16,1326,74,59,21,14,7,18,43,11,25,18,2578,13.60803324,985,132,12,0.421706396
Dahntay Jones,2563,2015-16,42,1,2,1,1,0,1,0,0,0,0,79,15.55555556,49,5,0,0
Mo Williams,2590,2015-16,748,41,98,27,19,8,52,57,21,29,28,1462,22.58258258,1290,204,21,0.739913233
Justin Anderson,1626147,2015-16,647,55,29,12,10,2,11,24,10,8,16,1288,15.58171745,674,67,3,0.44050929
Raymond Felton,101109,2015-16,2192,80,284,122,83,39,100,121,63,42,79,4286,18.43645485,3446,654,37,0.718868876
Charlie Villanueva,101111,2015-16,665,62,24,4,2,2,15,31,9,17,14,1348,24.35473197,770,48,0,0.442313812
J.J. Barea,200826,2015-16,1667,74,302,88,64,24,126,113,60,31,82,3296,23.53101197,3134,656,38,0.736226495
Dwight Powell,203939,2015-16,992,69,44,20,19,1,13,40,8,20,20,1963,18.21917808,1402,90,7,0.404919815
Deron Williams,101114,2015-16,2106,65,378,149,119,30,115,150,72,51,99,4129,22.16393443,4613,809,48,0.704593859
JaVale McGee,201580,2015-16,370,34,3,0,0,0,1,21,2,17,4,714,21.39303483,337,15,0,-0.063492063
Jeremy Evans,202379,2015-16,251,30,2,0,0,0,1,7,3,3,4,518,11.24780316,175,14,0,-0.023809524
Wesley Matthews,202083,2015-16,2644,78,151,59,47,12,46,78,26,26,52,5133,17.44695774,2660,324,22,0.384154798
Chandler Parsons,202718,2015-16,1799,61,169,73,41,32,56,95,36,31,64,3494,20.85492228,2182,328,18,0.538063192
Zaza Pachulia,2585,2015-16,2004,76,128,45,38,7,44,119,25,61,58,3861,16.63581675,2262,288,16,0.47054771
Devin Harris,2734,2015-16,1280,64,118,32,21,11,54,66,31,29,37,2567,17.49649369,1504,235,15,0.548455289
Dirk Nowitzki,1717,2015-16,2364,75,132,60,32,28,52,84,30,31,53,4652,25.5389396,2791,286,32,0.528287674
David Lee,101135,2015-16,888,54,84,35,20,15,23,66,18,27,39,1820,21.65200391,1320,172,5,0.484169884
Salah Mejri,1626257,2015-16,397,34,10,4,3,1,3,23,5,12,11,777,14.26914153,388,31,1,0.207246377
Darrell Arthur,201589,2015-16,1516,70,96,25,22,3,45,66,27,30,36,3016,16.88046647,1718,172,5,0.42758803
Emmanuel Mudiay,1626144,2015-16,2068,68,372,97,71,26,182,217,90,87,130,4171,25.38589904,3663,756,46,0.788932692
Jameer Nelson,2749,2015-16,1036,39,190,57,41,16,68,66,42,14,52,2027,16.60248181,1903,425,22,0.695498383
Mike Miller,2034,2015-16,373,47,40,13,12,1,21,17,10,7,10,759,9.143518519,524,68,6,0.320588235
Will Barton,203115,2015-16,2353,82,203,49,36,13,100,139,41,60,79,4676,23.06684142,2497,468,35,0.597528311
Axel Toupane,1626253,2015-16,305,21,15,5,1,4,3,6,4,1,5,594,12.59484067,205,26,3,-0.077777778
Danilo Gallinari,201568,2015-16,1839,53,135,33,24,9,69,77,20,39,38,3679,22.94811321,1767,282,11,0.570656796
JaKarr Sampson,203960,2015-16,1160,73,46,23,17,6,14,70,13,36,34,2316,16.90087353,847,106,11,0.525636621
D.J. Augustin,201571,2015-16,1178,62,198,49,27,22,94,84,34,34,50,2344,18.42105263,1859,406,27,0.753525131
Gary Harris,203914,2015-16,2439,76,147,40,30,10,65,98,29,44,54,4884,16.24158696,1550,295,13,0.508552702
Nikola Jokic,203999,2015-16,1733,80,189,60,40,20,93,104,33,50,54,3417,19.85869291,2587,347,10,0.637476566
Wilson Chandler,201163,2015-16,0,0,0,0,0,0,0,0,0,0,0,0,0,0,0,0,0
Jusuf Nurkic,203994,2015-16,547,32,40,12,8,4,20,55,10,28,27,1084,27.32371795,767,82,1,0.559848934
Kenneth Faried,202702,2015-16,1694,67,79,30,26,4,33,91,22,45,46,3358,20.71957132,1870,160,9,0.475649353
Joffrey Lauvergne,203530,2015-16,1041,59,56,22,18,4,23,54,14,34,20,2048,20.00860585,1329,116,5,0.545496293
Andre Drummond,203083,2015-16,2666,81,67,30,17,13,22,155,32,78,77,5244,24.28851816,1686,184,7,0.455345971
Reggie Jackson,202704,2015-16,2424,79,492,166,114,52,205,223,109,70,153,4819,28.74776386,4023,957,68,0.824716313
Kentavious Caldwell-Pope,203484,2015-16,2789,76,138,59,36,23,52,105,32,44,61,5530,17.97456576,1724,310,20,0.568329034
Darrun Hilliard,1626199,2015-16,383,38,27,12,9,3,5,19,4,12,7,753,19.60326721,259,67,4,0.173489279
Stanley Johnson,1626169,2015-16,1687,73,118,46,28,18,46,114,33,59,55,3335,19.65678627,1583,247,12,0.587955571
Aron Baynes,203382,2015-16,1233,81,51,22,16,6,16,67,9,44,23,2444,18.93830703,843,127,8,0.550990088
Marcus Morris,202694,2015-16,2856,80,201,71,42,29,76,140,56,64,76,5646,18.50828729,2929,389,14,0.486071884
Lorenzo Brown,203485,2015-16,61,8,11,3,2,1,6,9,3,5,4,121,25.92592593,131,18,3,0.336700337
Jodie Meeks,201975,2015-16,43,3,3,1,0,1,2,1,0,1,0,81,25,20,3,1,0.666666667
Steve Blake,2581,2015-16,986,58,200,77,53,24,74,81,47,24,57,1934,14.83318305,2004,434,21,0.843827904
Reggie Bullock,203493,2015-16,429,37,27,10,6,4,9,8,2,5,3,834,11.49897331,472,51,0,0.24537037
Tobias Harris,202699,2015-16,2469,75,169,68,44,24,47,108,24,53,55,4941,19.55903272,3033,348,28,0.433072588
Anthony Tolliver,201229,2015-16,1341,72,52,20,14,6,16,28,11,15,13,2616,12.58278146,1726,149,9,0.401650332
Joel Anthony,201202,2015-16,96,19,1,0,0,0,1,2,1,1,1,187,7.272727273,37,1,0,0.5
Brandon Rush,201575,2015-16,1055,72,57,23,15,8,17,33,13,11,22,2170,12.79699875,998,103,10,0.347035575
Marreese Speights,201578,2015-16,832,72,61,22,17,5,21,66,11,34,32,1678,30.10526316,1093,108,7,0.438586843
Andre Iguodala,2738,2015-16,1732,65,219,90,66,24,96,79,38,28,51,3565,12.03082277,2140,399,34,0.717609975
Klay Thompson,202691,2015-16,2666,80,166,52,31,21,86,138,50,58,80,5558,26.31664499,2007,323,47,0.586847263
Andrew Bogut,101106,2015-16,1451,70,162,68,54,14,58,83,41,35,48,2973,11.68437026,2128,304,23,0.604041185
Anderson Varejao,2760,2015-16,496,53,35,16,13,3,11,22,6,14,8,992,14.68531469,732,79,7,0.316883117
Leandro Barbosa,2571,2015-16,1079,68,82,27,17,10,35,53,21,21,32,2206,17.93240557,1106,172,21,0.536428595
James Michael McAdoo,203949,2015-16,262,41,17,7,7,0,4,16,5,8,8,546,19.68,397,29,2,0.147058824
Ian Clark,203546,2015-16,578,66,64,27,25,2,15,43,17,11,32,1169,19.89329268,873,110,9,0.391168361
Draymond Green,203110,2015-16,2808,81,598,215,145,70,268,259,121,103,156,5892,18.68031159,5261,1106,49,0.87768761
Stephen Curry,201939,2015-16,2700,79,527,168,122,46,264,262,114,106,156,5701,31.79026925,4476,997,72,0.87993051
Festus Ezeli,203105,2015-16,770,46,32,19,12,7,3,38,11,18,20,1586,18.065592,841,63,4,0.335457072
Shaun Livingston,2733,2015-16,1520,78,237,73,53,20,87,78,33,36,42,3041,14.39790576,2618,455,26,0.635423869
Kevon Looney,1626172,2015-16,21,5,0,0,0,0,0,1,0,1,0,46,14.28571429,36,3,0,0
Harrison Barnes,203084,2015-16,2042,66,117,61,45,16,33,57,16,31,26,4211,15.94202899,1983,212,22,0.528767195
Andrew Goudelock,202726,2015-16,50,8,4,1,1,0,3,7,4,2,5,105,24.16666667,76,11,1,0.428571429
Trevor Ariza,2772,2015-16,2859,81,188,80,52,28,78,113,48,51,62,5755,15.89041096,3002,420,29,0.611012584
Patrick Beverley,201976,2015-16,2041,71,239,88,55,33,104,91,38,44,47,4087,15.59613319,3131,484,34,0.689574633
Josh Smith,2746,2015-16,880,55,90,28,10,18,43,77,36,31,46,1786,22.89276808,1214,181,5,0.611197079
Terrence Jones,203093,2015-16,1044,50,41,22,15,7,17,49,11,26,23,2108,19.44096788,1219,90,6,0.621461499
Sam Dekker,1626155,2015-16,6,3,0,0,0,0,0,0,0,0,0,14,0,9,1,0,0
Michael Beasley,201563,2015-16,363,20,16,4,2,2,7,24,9,11,13,744,29.11832947,398,39,4,0.173611111
Dwight Howard,2730,2015-16,2280,71,98,37,28,9,45,166,29,108,58,4566,18.765622,2696,214,17,0.560172001
James Harden,201935,2015-16,3125,82,612,234,128,106,294,374,181,114,260,6334,32.39085239,4265,1216,58,0.971914081
Clint Capela,203991,2015-16,1471,77,47,14,11,3,24,60,13,30,30,2963,16.03252977,1592,119,6,0.464156731
Donatas Motiejunas,202700,2015-16,547,37,41,14,10,4,23,44,19,19,25,1117,21.87748608,743,85,3,0.649505881
Jason Terry,1891,2015-16,1258,72,103,43,30,13,49,49,31,15,34,2553,15.05154639,1526,215,9,0.640375452
KJ McDaniels,203909,2015-16,235,37,10,2,1,1,4,17,6,9,8,480,18.72727273,152,19,1,0.109803922
Corey Brewer,201147,2015-16,1669,82,109,39,23,16,56,78,38,25,53,3445,17.75724917,1195,212,17,0.6161586
Montrezl Harrell,1626149,2015-16,379,39,17,9,7,2,8,17,6,8,9,778,14.60928652,324,31,2,0.490196078
CJ Miles,101139,2015-16,1464,64,63,24,15,9,27,70,31,29,41,3019,22.50966399,1249,146,9,0.497572672
Joe Young,1626202,2015-16,384,41,65,11,6,5,21,33,14,12,21,778,23.92776524,640,127,5,-0.053146853
Rodney Stuckey,201155,2015-16,1275,58,142,51,32,19,56,76,30,28,48,2527,20.72740113,1397,329,19,0.703205346
George Hill,201588,2015-16,2524,74,259,76,49,27,81,101,37,49,52,5035,16.00566572,4204,632,33,0.501956324
Lavoy Allen,202730,2015-16,1599,79,76,31,22,9,25,69,30,29,40,3117,13.15129563,2080,201,12,0.432610237
Ty Lawson,201951,2015-16,1411,66,237,83,50,33,106,95,57,27,68,2905,14.8385131,2276,530,25,0.834023332
Monta Ellis,101145,2015-16,2734,81,383,127,78,49,163,203,82,83,120,5540,21.06782107,3892,861,52,0.762948699
Paul George,202331,2015-16,2819,81,329,72,42,30,174,265,92,115,150,5726,30.06993007,3119,673,45,0.680219214
Rakeem Christmas,1626176,2015-16,6,1,0,0,0,0,0,0,0,0,0,13,14.28571429,4,1,0,0
Jordan Hill,201941,2015-16,1513,73,87,30,21,9,30,92,22,47,45,2978,20.51131355,2084,217,9,0.440828702
Ian Mahinmi,101133,2015-16,1816,71,104,44,29,15,27,100,22,62,38,3656,15.91576885,2251,237,8,0.458485455
Myles Turner,1626167,2015-16,1367,60,41,16,13,3,13,67,12,45,22,2782,21.11255693,1430,87,7,0.389013178
Glenn Robinson III,203922,2015-16,508,45,26,5,2,3,12,18,8,5,13,1012,16.04831752,449,64,6,0.348295307
Shayne Whittington,203963,2015-16,41,7,3,1,1,0,1,5,0,4,1,83,17.70833333,46,9,0,0.266666667
Solomon Hill,203524,2015-16,866,59,57,16,8,8,23,33,12,16,17,1727,13.19514661,1001,130,7,0.459145625
Chris Paul,101108,2015-16,2420,74,738,234,174,60,295,194,92,73,121,4865,26.83243644,4612,1421,68,1.070864417
JJ Redick,200755,2015-16,2097,75,106,37,22,15,49,78,33,31,47,4218,22.33404711,1514,230,39,0.538728672
DeAndre Jordan,201599,2015-16,2598,77,90,27,16,11,33,107,25,59,48,5163,15.65005228,3255,185,10,0.311844883
Jeff Green,201145,2015-16,2253,80,138,52,27,25,42,93,28,41,52,4358,20.83333333,2286,264,27,0.39410882
Pablo Prigioni,203143,2015-16,823,59,130,48,27,21,47,49,28,14,35,1604,11.14221725,1554,271,14,0.663012444
Jamal Crawford,2037,2015-16,2126,79,183,51,36,15,100,113,44,43,70,4288,24.46360959,1969,395,29,0.67171797
Luc Mbah a Moute,201601,2015-16,1274,75,30,14,11,3,8,34,9,16,18,2462,9.751643535,833,79,6,0.380376766
Jeff Ayres,201965,2015-16,107,17,5,1,1,0,4,6,1,5,1,215,13.97379913,140,11,0,0.611111111
Branden Dawson,1626183,2015-16,29,6,0,0,0,0,0,0,0,0,0,57,8.196721311,15,1,0,0
Austin Rivers,203085,2015-16,1464,67,99,47,26,21,24,61,23,24,37,2916,19.49705061,1820,222,22,0.455269958
CJ Wilcox,203912,2015-16,167,23,10,2,2,0,2,2,1,1,1,341,19.51871658,133,18,2,-0.1
Blake Griffin,201933,2015-16,1170,35,170,71,49,22,45,83,26,31,52,2363,29.31818182,2065,322,12,0.571330145
Wesley Johnson,202325,2015-16,1666,80,49,19,16,3,24,54,22,25,29,3371,15.71199143,1361,102,6,0.501374725
Paul Pierce,1718,2015-16,1231,68,71,25,13,12,34,58,23,24,34,2439,18.16143498,1258,137,7,0.522444937
Cole Aldrich,202332,2015-16,800,60,50,25,14,11,11,64,16,38,26,1549,19.10308678,1252,112,4,0.480706869
Nick Young,201156,2015-16,1033,54,34,10,9,1,16,30,7,16,14,2024,18.62278042,689,77,4,0.462113336
D'Angelo Russell,1626156,2015-16,2259,80,266,77,61,16,106,196,81,74,122,4496,24.16291365,3608,587,24,0.569697103
Brandon Bass,101138,2015-16,1342,66,74,27,20,7,22,42,8,28,14,2673,13.9657444,1244,162,8,0.468658148
Anthony Brown,1626148,2015-16,599,29,19,7,4,3,5,15,6,5,10,1192,11.03752759,452,45,4,0.250706123
Ryan Kelly,203527,2015-16,470,36,20,7,6,1,9,18,3,9,9,948,17.75092937,549,37,2,0.3
Jordan Clarkson,203903,2015-16,2552,79,192,66,49,17,65,135,36,65,70,5096,22.89970553,2898,414,17,0.481201675
Larry Nance Jr.,1626204,2015-16,1266,63,44,17,12,5,11,40,10,21,19,2505,12.62714837,1716,124,4,0.314904329
Marcelo Huertas,1626273,2015-16,869,53,182,51,37,14,87,80,50,20,60,1696,16.41713991,1561,359,17,0.818007734
Roy Hibbert,201579,2015-16,1878,81,95,26,19,7,27,76,21,43,33,3727,13.17165953,1740,200,10,0.301263363
Lou Williams,101150,2015-16,1907,67,167,43,27,16,79,107,51,34,73,3830,22.54856614,1750,370,18,0.575241854
Kobe Bryant,977,2015-16,1863,66,184,48,39,9,79,129,66,37,92,3766,31.79463024,1592,347,13,0.523381506
Tarik Black,204028,2015-16,496,39,16,7,7,0,4,22,4,8,14,972,13.29739443,557,35,0,0.142045455
Julius Randle,203944,2015-16,2286,81,144,71,55,16,37,149,38,74,75,4557,21.26592049,3339,332,12,0.493544245
Metta World Peace,1897,2015-16,590,35,27,6,4,2,9,15,4,8,7,1133,16.69207317,477,51,3,0.260025584
Robert Sacre,203135,2015-16,320,25,14,6,5,1,2,12,3,8,4,650,14.05835544,297,30,1,0.126984127
JaMychal Green,203210,2015-16,1446,78,67,17,14,3,29,83,12,50,33,2871,19.30992736,1760,157,4,0.418483636
Lance Stephenson,202362,2015-16,1372,69,133,33,22,11,67,94,30,50,44,2706,19.95464853,1253,271,12,0.676320789
Jordan Adams,203919,2015-16,15,2,3,0,0,0,2,2,0,0,2,33,28.57142857,13,3,0,0
Jordan Farmar,200770,2015-16,291,12,37,9,5,4,16,18,9,7,11,567,18.04733728,563,102,4,0.138638639
Chris Andersen,2365,2015-16,403,27,12,4,3,1,6,9,4,3,6,762,11.18644068,404,30,0,0.277777778
Bryce Cotton,203955,2015-16,39,8,3,1,1,0,0,5,2,2,3,78,17.24137931,54,7,1,-0.2
Tony Allen,2754,2015-16,1620,64,70,11,9,2,27,78,26,33,45,3070,17.04927212,1304,154,12,0.230376005
Jarell Martin,1626185,2015-16,380,27,15,5,4,1,6,19,4,9,10,741,18.3972912,409,28,3,0.224561404
Mike Conley,201144,2015-16,1761,56,342,72,53,19,111,84,42,27,57,3377,23.01420305,3464,641,49,0.524607828
Xavier Munford,204098,2015-16,244,14,22,3,3,0,13,15,3,9,6,480,17.04745167,375,48,1,0.260606061
Vince Carter,1713,2015-16,1005,60,56,15,8,7,23,35,12,16,19,1995,17.99474606,1130,124,7,0.397403312
PJ Hairston,203798,2015-16,1313,66,38,14,12,2,12,41,15,18,23,2570,16.47589317,832,105,3,0.370056782
Matt Barnes,2440,2015-16,2190,76,163,29,15,14,83,121,59,46,75,4274,17.77868186,2904,327,22,0.409090035
Marc Gasol,201188,2015-16,1791,52,196,57,46,11,74,118,31,47,71,3432,24.11128284,2524,434,17,0.548741053
Brandan Wright,201148,2015-16,212,12,6,2,1,1,2,10,1,8,2,414,15.41755889,204,21,1,0.266666667
Zach Randolph,2216,2015-16,2016,68,142,57,52,5,52,105,35,49,56,3878,24.98878421,2168,330,17,0.572399021
Josh Richardson,1626196,2015-16,1107,52,73,20,13,7,22,35,13,17,18,2143,13.7704918,1452,169,9,0.339636606
Chris Bosh,2547,2015-16,1778,53,128,36,23,13,50,78,29,28,50,3405,25.40940306,2341,259,15,0.381172224
Joe Johnson,2207,2015-16,2703,81,318,75,39,36,116,159,58,63,96,5326,18.04511278,2901,616,39,0.50627324
Dwyane Wade,2548,2015-16,2258,74,344,101,46,55,173,203,81,69,134,4399,31.69156237,2628,658,28,0.784934297
Josh McRoberts,201177,2015-16,595,42,81,17,14,3,38,30,14,11,19,1147,15.29411765,996,157,8,0.55606397
Amar'e Stoudemire,2405,2015-16,762,52,27,6,1,5,7,47,7,28,19,1475,18.07155852,612,64,3,0.20196104
Goran Dragic,201609,2015-16,2363,72,419,108,65,43,175,185,72,80,105,4634,21.60106484,4571,857,56,0.703056032
Tyler Johnson,204020,2015-16,863,36,79,24,14,10,26,47,21,17,30,1641,17.13665944,1311,166,17,0.405785261
Luol Deng,2736,2015-16,2394,74,140,48,25,23,61,81,30,34,47,4695,17.19781256,2988,271,18,0.455718241
Dorell Wright,2748,2015-16,0,0,0,0,0,0,0,0,0,0,0,0,0,0,0,0,0
Briante Weber,1627362,2015-16,169,7,21,6,5,1,12,9,7,1,8,333,11.84834123,336,46,2,0.227513228
Gerald Green,101123,2015-16,1557,69,56,12,5,7,24,46,12,29,17,3023,19.75199291,1003,128,10,0.396161929
Justise Winslow,1626159,2015-16,2232,78,118,30,15,15,52,95,30,41,54,4345,12.47698916,2444,275,24,0.40783658
Hassan Whiteside,202355,2015-16,2125,73,29,3,2,1,17,135,22,82,53,4078,20.53475936,1549,93,2,0.329261082
Udonis Haslem,2617,2015-16,260,37,14,3,3,0,6,5,1,4,1,492,13.77358491,324,23,5,0.242857143
O.J. Mayo,201564,2015-16,1090,41,118,18,16,2,61,72,36,25,47,2153,16.87293729,1292,189,17,0.438244925
Michael Carter-Williams,203487,2015-16,1649,54,281,64,45,19,133,153,75,53,100,3275,21.01293103,2955,567,34,0.685592286
Steve Novak,200779,2015-16,44,10,0,0,0,0,0,1,1,0,1,99,17.27272727,38,3,0,0
Tyler Ennis,203898,2015-16,654,46,95,22,14,8,43,46,25,15,31,1278,17.18641719,1148,194,17,0.591865144
Jabari Parker,203953,2015-16,2408,76,130,27,17,10,73,116,38,55,61,4727,20.91283202,2736,251,17,0.456585726
Greg Monroe,202328,2015-16,2314,79,178,54,38,16,82,129,31,58,71,4538,23.54549004,2270,342,18,0.545705895
Damien Inglis,203996,2015-16,156,20,10,2,1,1,5,11,4,6,5,302,15.47619048,160,19,2,0.215151515
Miles Plumlee,203101,2015-16,870,61,16,2,1,1,4,40,12,22,18,1710,15.48353909,836,63,6,0.039439311
Jerryd Bayless,201573,2015-16,1505,52,163,41,28,13,59,73,33,31,42,2909,16.71751068,1980,340,28,0.48601357
Rashad Vaughn,1626173,2015-16,1001,70,39,8,5,3,18,28,12,9,19,1954,13.37494427,566,65,5,0.286918911
Greivis Vasquez,202349,2015-16,460,23,91,24,17,7,43,40,19,17,23,878,18.75626881,885,188,9,0.211263736
Khris Middleton,203114,2015-16,2852,79,331,42,23,19,208,180,75,68,112,5644,22.77585665,2934,607,36,0.634264167
John Henson,203089,2015-16,960,57,54,13,10,3,26,64,18,32,32,1857,19.26345609,859,115,6,0.47589049
Giannis Antetokounmpo,203507,2015-16,2823,80,345,64,41,23,161,208,63,110,98,5532,22.47801759,3936,648,44,0.555966483
Johnny O'Bryant III,203948,2015-16,857,66,32,9,7,2,10,31,10,15,16,1635,13.80977969,1005,72,3,0.244029449
Tyus Jones,1626145,2015-16,573,37,108,27,12,15,56,33,21,7,26,1130,15.74864236,1068,224,12,0.773221707
Greg Smith,202962,2015-16,0,0,0,0,0,0,0,0,0,0,0,0,0,0,0,0,0
Gorgui Dieng,203476,2015-16,2220,82,143,39,24,15,59,140,29,90,50,4362,16.94603434,2321,261,18,0.46295283
Zach LaVine,203897,2015-16,2294,82,251,52,40,12,108,155,51,65,90,4606,23.3281493,2849,513,43,0.514258511
Ricky Rubio,201937,2015-16,2323,76,658,82,61,21,292,193,103,62,131,4625,17.59953837,4696,1229,53,0.799572914
Damjan Rudez,204014,2015-16,277,33,11,2,0,2,4,13,5,8,5,553,12.68057785,339,39,2,0.083916084
Tayshaun Prince,2419,2015-16,1462,77,74,17,15,2,23,27,6,14,13,2796,8.367540259,1192,160,5,0.290380692
Nikola Pekovic,201593,2015-16,156,12,11,5,3,2,1,9,1,5,4,289,21.03658537,84,24,1,0.063973064
Shabazz Muhammad,203498,2015-16,1682,82,52,13,8,5,27,70,18,38,32,3303,23.02543507,851,107,7,0.472865658
Kevin Garnett,708,2015-16,556,38,62,11,10,1,19,16,4,11,5,1079,11.75,998,103,6,0.334829179
Andrew Wiggins,203952,2015-16,2845,81,164,43,30,13,53,182,53,71,111,5684,27.05827214,1924,371,35,0.371967478
Karl-Anthony Towns,1626157,2015-16,2627,82,161,41,33,8,66,183,49,105,78,5230,24.63472647,2855,359,17,0.45158853
Adreian Payne,203940,2015-16,486,52,29,7,7,0,10,36,11,16,20,953,18.08014911,740,60,5,0.067688378
Nemanja Bjelica,202357,2015-16,1075,60,82,18,11,7,40,47,13,21,26,2131,12.69709544,1890,182,12,0.455185199
Tyreke Evans,201936,2015-16,765,25,164,62,47,15,53,73,25,32,41,1482,25.73134328,1514,328,16,0.826074387
Tim Frazier,204025,2015-16,741,51,162,48,35,13,66,65,18,29,36,1477,19.61607678,1375,337,20,0.885636718
Omer Asik,201600,2015-16,1178,68,26,8,7,1,9,60,18,33,27,2330,11.63141994,1569,64,1,0.265632505
James Ennis III,203516,2015-16,329,22,21,0,0,0,14,19,3,7,12,650,19.9192463,224,27,8,0.122807018
Kendrick Perkins,2570,2015-16,542,37,31,8,4,4,12,41,10,22,19,1091,10.62240664,704,46,3,0.30756817
Luke Babbitt,202337,2015-16,845,47,53,18,15,3,20,23,5,10,13,1736,17.0343766,863,92,3,0.410722608
Eric Gordon,201569,2015-16,1481,45,121,29,16,13,46,73,17,37,36,2998,20.53923054,1212,241,11,0.483690587
Jrue Holiday,201950,2015-16,1831,65,391,119,90,29,155,167,85,47,120,3723,28.76712329,3006,788,35,0.820421274
Alonzo Gee,202087,2015-16,1632,73,72,28,23,5,24,55,13,31,24,3279,9.249658936,1172,125,8,0.426682771
Toney Douglas,201962,2015-16,1262,61,157,49,33,16,63,64,26,29,35,2557,19.26956522,1897,313,18,0.610767178
Quincy Pondexter,202347,2015-16,0,0,0,0,0,0,0,0,0,0,0,0,0,0,0,0,0
Anthony Davis,203076,2015-16,2164,61,116,42,33,9,50,121,22,65,56,4371,29.44078947,2654,249,8,0.514385486
Jordan Hamilton,202706,2015-16,304,11,25,9,7,2,10,17,6,6,11,608,20.66957787,270,50,4,0.210980392
Norris Cole,202708,2015-16,1198,45,167,36,28,8,67,75,40,24,51,2422,21.67034584,1905,340,14,0.519050501
Ryan Anderson,201583,2015-16,2008,66,73,28,17,11,26,90,19,48,42,4103,24.16630576,1870,125,12,0.379933054
Alexis Ajinca,201582,2015-16,861,59,31,13,12,1,12,54,9,27,27,1719,20.60353798,1071,61,2,0.43425558
Dante Cunningham,201967,2015-16,1971,80,77,24,20,4,21,41,16,18,23,3949,11.13883848,1645,120,11,0.19792151
Kevin Seraphin,202338,2015-16,526,48,47,6,4,2,18,43,11,23,20,1035,22.60034904,791,96,2,0.326141071
Langston Galloway,204038,2015-16,2033,82,207,66,46,20,67,61,29,28,33,3979,15.46666667,2984,438,30,0.491078872
Jose Calderon,101181,2015-16,2024,72,298,98,65,33,80,87,52,21,66,3907,12.68589455,4208,684,38,0.511600732
Arron Afflalo,201167,2015-16,2371,71,144,47,39,8,33,82,21,41,41,4564,18.09542281,2727,363,25,0.341768825
Tony Wroten,203100,2015-16,144,8,20,6,2,4,11,29,11,17,12,299,33.03834808,283,50,0,0.378735632
Kristaps Porzingis,204001,2015-16,2047,72,94,36,24,12,30,121,35,48,73,3959,24.81719477,2942,207,11,0.339176292
Carmelo Anthony,2546,2015-16,2530,72,299,106,73,33,98,176,57,88,88,4910,29.56042,3029,610,40,0.624767563
Robin Lopez,201577,2015-16,2219,82,114,30,24,6,24,133,31,66,67,4266,17.73962804,2775,286,8,0.204381027
Kyle O'Quinn,203124,2015-16,764,65,72,12,10,2,36,61,22,32,29,1488,21.22110255,1395,150,5,0.478725348
Cleanthony Early,203921,2015-16,154,17,6,2,2,0,3,9,3,5,4,295,15.04424779,145,12,2,0.351851852
Jerian Grant,1626170,2015-16,1265,76,177,64,40,24,58,87,48,24,63,2468,18.93533405,2337,442,28,0.653091373
Lou Amundson,200811,2015-16,204,29,12,1,0,1,3,15,3,8,7,391,17.2489083,251,21,0,-0.155555556
Sasha Vujacic,2756,2015-16,908,61,84,28,16,12,23,44,18,18,26,1780,16.43169665,1334,217,24,0.478495277
Derrick Williams,202682,2015-16,1435,80,75,22,20,2,23,61,19,22,39,2792,23.68337057,1704,172,13,0.274351507
Lance Thomas,202498,2015-16,1313,59,53,13,12,1,12,57,19,25,32,2552,17.11680112,1382,139,7,0.157673581
Russell Westbrook,201566,2015-16,2750,80,834,160,107,53,403,343,177,109,234,5578,31.52777778,4566,1561,58,1.023832461
Anthony Morrow,201627,2015-16,926,68,24,9,6,3,13,17,6,6,11,1860,17.08920188,475,59,3,0.555572488
Dion Waiters,203079,2015-16,2152,78,154,66,40,26,52,120,43,58,62,4356,17.66213286,1368,339,11,0.666013109
Nick Collison,2555,2015-16,699,59,52,8,7,1,26,50,23,20,30,1376,10.78250154,703,112,1,0.440058931
Kyle Singler,202713,2015-16,977,68,24,7,4,3,13,32,10,15,17,1976,11.62393162,618,61,1,0.484058197
Randy Foye,200751,2015-16,1642,81,161,53,40,13,62,86,42,32,54,3229,16.07717042,1859,353,18,0.576518821
Serge Ibaka,201586,2015-16,2500,78,66,38,22,16,20,108,25,57,51,5036,17.6520994,1694,143,14,0.529662722
Enes Kanter,202683,2015-16,1721,82,33,16,16,0,7,115,13,77,38,3422,23.41850657,2564,92,7,0.342830164
Steven Adams,203500,2015-16,2014,80,62,22,15,7,17,84,15,56,28,4031,12.75641026,2944,163,10,0.320888127
Nazr Mohammed,1737,2015-16,19,5,0,0,0,0,0,3,0,3,0,42,20,18,3,0,0
Andre Roberson,203460,2015-16,1553,70,47,17,13,4,15,35,8,23,12,3082,9.36623668,826,113,10,0.442798286
Cameron Payne,1626166,2015-16,698,57,108,35,25,10,40,44,19,20,24,1386,20.40565458,1106,215,9,0.681710065
Mitch McGary,203956,2015-16,72,20,3,1,0,1,0,7,2,3,4,160,20.11494253,90,8,0,-0.19047619
Josh Huestis,203962,2015-16,55,5,0,0,0,0,0,3,2,0,3,111,13.49206349,24,0,0,0
Kevin Durant,201142,2015-16,2578,72,361,105,39,66,140,250,102,77,173,5239,30.3426585,2638,726,29,0.671492505
Aaron Gordon,203932,2015-16,1857,77,128,27,20,7,59,66,13,36,30,3727,17.25684608,2158,221,10,0.408445308
Dewayne Dedmon,203473,2015-16,705,58,13,5,5,0,5,32,6,19,13,1403,15.29263688,642,44,1,0.431427942
Elfrid Payton,203901,2015-16,2125,72,467,113,84,29,181,177,81,66,111,4301,20.04880033,4176,935,38,0.751075907
Victor Oladipo,203506,2015-16,2334,71,282,78,54,24,92,153,61,56,97,4759,22.85555143,2853,528,37,0.469463999
Ersan Ilyasova,101141,2015-16,1880,74,67,24,15,9,20,71,17,45,26,3772,18.29157175,2276,158,9,0.354779945
Nikola Vucevic,202696,2015-16,1998,64,179,86,68,18,69,123,32,62,61,4051,26.83935568,2534,405,15,0.729805865
Evan Fournier,203095,2015-16,2532,78,214,42,28,14,75,133,52,46,87,5074,20.3567681,2482,471,32,0.371135801
Devyn Marble,203906,2015-16,249,28,12,6,3,3,4,7,1,3,4,513,15.50522648,169,28,0,0.30952381
Shabazz Napier,203894,2015-16,600,55,97,37,27,10,26,46,21,20,26,1175,20.22813688,1053,218,10,0.698106279
Jason Smith,201160,2015-16,1144,75,62,20,15,5,21,57,16,34,23,2349,22.54114045,1518,125,8,0.385064991
Mario Hezonja,1626209,2015-16,1399,78,109,19,11,8,46,97,34,43,54,2833,17.00315457,1316,239,18,0.429877185
C.J. Watson,201228,2015-16,656,33,88,26,17,9,24,25,9,14,11,1339,12.00269724,984,179,4,0.542958241
Andrew Nicholson,203094,2015-16,820,55,25,15,8,7,3,41,9,23,18,1624,20.8839779,792,60,5,0.389253511
Brandon Jennings,201943,2015-16,868,48,170,52,38,14,68,57,30,19,38,1753,19.75927783,1694,370,18,0.795012024
Isaiah Canaan,203477,2015-16,1966,77,137,50,41,9,55,91,42,39,52,3972,19.59247649,2642,320,19,0.526501237
Ish Smith,202397,2015-16,2239,77,502,173,135,38,210,175,93,42,133,4563,23.8861629,4893,1030,47,0.846813141
Nerlens Noel,203457,2015-16,1965,67,122,39,30,9,62,158,41,71,87,3964,19.13357401,2793,267,9,0.542465211
Kendall Marshall,203088,2015-16,400,30,73,23,15,8,32,43,19,19,24,834,18.33150384,716,167,9,0.234044813
Carl Landry,201171,2015-16,569,36,32,17,13,4,8,22,5,13,9,1161,24.22839506,687,66,1,0.523615869
Jahlil Okafor,1626143,2015-16,1591,53,65,22,18,4,27,124,20,71,53,3154,27.83417936,1565,153,7,0.471969214
Nik Stauskas,203917,2015-16,1809,73,138,39,22,17,66,94,41,30,64,3700,16.67877027,1971,320,14,0.539833323
T.J. McConnell,204456,2015-16,1606,81,367,154,102,52,150,140,63,51,89,3223,17.22421897,3806,807,29,0.997624071
Joel Embiid,203954,2015-16,0,0,0,0,0,0,0,0,0,0,0,0,0,0,0,0,0
Richaun Holmes,1626158,2015-16,702,51,33,12,8,4,15,32,6,17,15,1432,17.64342998,794,56,3,0.478899532
Hollis Thompson,203138,2015-16,2154,77,99,34,21,13,45,76,30,38,38,4395,16.08377389,1673,225,16,0.536925565
Robert Covington,203496,2015-16,1903,67,97,31,21,10,54,143,38,71,72,3897,21.30884041,2418,197,9,0.560116206
Christian Wood,1626174,2015-16,145,17,3,1,1,0,2,2,0,1,1,308,19.11764706,172,11,1,0.5
Jerami Grant,203924,2015-16,2066,77,135,63,44,19,43,110,26,64,46,4155,18.49374191,2604,279,15,0.554644332
Elton Brand,1882,2015-16,225,17,18,11,8,3,5,11,3,3,8,458,17.30382294,341,35,0,0.313131313
Devin Booker,1626164,2015-16,2108,76,200,70,45,25,88,160,80,53,107,4301,23.20228152,2018,481,17,0.700283175
Eric Bledsoe,202339,2015-16,1059,31,190,67,48,19,80,110,53,43,67,2196,27.25806452,1915,435,31,0.875239494
Brandon Knight,202688,2015-16,1870,52,263,110,75,35,99,177,92,50,127,3838,26.23400366,2973,582,41,0.729163901
Tyson Chandler,2199,2015-16,1618,66,64,21,15,6,26,93,28,57,36,3256,12.84990669,2083,184,6,0.474064185
Chase Budinger,201978,2015-16,930,66,64,16,13,3,32,44,17,22,22,1879,14.27247451,809,137,8,0.566656698
TJ Warren,203933,2015-16,1070,47,44,17,14,3,11,32,10,16,16,2208,19.86491855,913,105,10,0.349499954
Ronnie Price,101179,2015-16,1211,62,147,47,37,10,53,70,33,23,47,2466,13.76760563,2165,358,22,0.584110671
Alan Williams,1626210,2015-16,68,10,5,2,2,0,3,6,1,4,2,151,20,78,6,0,0.555555556
PJ Tucker,200782,2015-16,2540,82,177,58,43,15,74,111,37,60,51,5169,12.7190027,2610,391,18,0.563021662
Archie Goodwin,203462,2015-16,1114,57,118,41,29,12,39,100,48,31,69,2297,23.2204035,1653,245,18,0.482776321
Alex Len,203458,2015-16,1821,78,97,37,27,10,33,145,38,81,64,3710,20.53320861,2042,215,8,0.464545643
John Jenkins,203098,2015-16,480,43,35,13,9,4,10,27,12,10,17,1013,17.04545455,419,88,5,0.113932981
Jon Leuer,202720,2015-16,1255,67,72,28,23,5,29,75,33,29,46,2598,19.98633413,1766,156,6,0.466526899
Mirza Teletovic,203141,2015-16,1686,79,89,33,25,8,43,84,26,37,47,3494,23.31658291,2402,217,14,0.553139695
Damian Lillard,203081,2015-16,2676,75,512,193,126,67,202,242,125,77,165,5416,30.89141005,4535,1030,49,0.822903536
Brian Roberts,203148,2015-16,470,51,54,21,13,8,13,23,12,7,16,941,19.21274602,737,133,10,0.064412238
CJ McCollum,203468,2015-16,2780,80,341,117,74,43,137,196,70,89,107,5573,27.12264151,3646,755,53,0.708220894
Maurice Harkless,203090,2015-16,1457,78,67,27,19,8,25,62,18,29,33,2924,15.63712325,1301,134,7,0.46033421
Pat Connaughton,1626192,2015-16,143,34,10,5,4,1,3,10,5,2,8,294,18.31831832,143,21,2,0.2
Al-Farouq Aminu,202329,2015-16,2341,82,138,59,40,19,49,120,32,58,62,4716,16.87755862,2018,261,15,0.517879932
Gerald Henderson,201945,2015-16,0,0,0,0,0,0,0,0,0,0,0,0,0,0,0,0,0
Meyers Leonard,203086,2015-16,1333,61,92,42,31,11,25,77,28,38,39,2658,17.7,1779,194,13,0.48068278
Ed Davis,202334,2015-16,1684,81,88,32,22,10,25,64,12,37,27,3310,12.81045752,2092,198,14,0.385992408
Noah Vonleh,203943,2015-16,1174,78,30,17,11,6,7,50,6,37,13,2296,13.31562974,1377,93,2,0.526754481
Allen Crabbe,203459,2015-16,2105,81,99,36,28,8,38,64,17,31,33,4235,16.23578077,1664,220,19,0.478991017
Mason Plumlee,203486,2015-16,2084,82,226,91,67,24,77,154,50,68,86,4158,17.45863386,2530,473,15,0.637806205
Cliff Alexander,1626146,2015-16,36,8,0,0,0,0,0,1,0,0,1,74,14.28571429,39,2,0,0
Chris Kaman,2549,2015-16,112,16,11,3,2,1,4,8,3,4,4,220,20.88353414,128,20,0,0.136363636
Luis Montero,1626242,2015-16,42,12,1,0,0,0,1,4,1,2,2,82,26.88172043,40,4,0,0.5
Willie Cauley-Stein,1626161,2015-16,1394,65,37,11,11,0,19,46,15,17,29,2899,13.48484848,1059,89,8,0.415219149
Marco Belinelli,201158,2015-16,1646,67,127,44,28,16,51,80,39,29,51,3467,19.67128916,1396,239,20,0.518602087
James Anderson,202341,2015-16,717,50,41,16,5,11,15,42,14,22,20,1500,13.74631268,512,101,7,0.602164408
Darren Collison,201954,2015-16,2192,73,318,97,82,15,125,130,56,48,82,4591,19.29316338,3280,675,41,0.668254103
Rudy Gay,200752,2015-16,2348,69,120,41,28,13,54,139,49,48,91,4944,22.5499011,2263,281,28,0.483955688
Rajon Rondo,200765,2015-16,2513,71,839,195,135,60,386,278,131,117,161,5321,18.86352275,5318,1610,51,1.109526081
Quincy Acy,203112,2015-16,869,58,27,8,5,3,9,27,5,18,9,1800,13.18093385,831,69,4,0.347619287
DeMarcus Cousins,202326,2015-16,2221,64,214,72,48,24,107,249,71,109,140,4720,35.46434651,2647,433,26,0.674237572
Omri Casspi,201956,2015-16,1880,69,95,20,16,4,50,94,37,45,49,3909,17.78129236,2388,200,15,0.419884979
Ben McLemore,203463,2015-16,1418,67,79,24,16,8,41,99,19,46,53,3035,17.4904943,1017,137,12,0.54232518
Eric Moreland,203961,2015-16,43,7,1,1,1,0,0,3,0,2,1,103,9.821428571,45,3,0,0.555555556
Duje Dukan,1626251,2015-16,24,1,1,0,0,0,1,0,0,0,0,50,16.12903226,21,3,0,0
Seth Curry,203552,2015-16,669,43,67,19,13,6,28,36,13,21,15,1433,17.49379653,711,123,7,0.586122598
Caron Butler,2406,2015-16,168,16,10,4,1,3,4,3,1,1,2,363,16.42156863,185,19,1,0.244444444
Kosta Koufos,201585,2015-16,1463,77,33,14,9,5,10,48,10,29,19,3030,15.53117783,1275,95,2,0.401439818
Kyle Anderson,203937,2015-16,1245,78,123,31,21,10,58,59,27,26,33,2426,14.55696203,1674,228,17,0.523136471
Kawhi Leonard,202695,2015-16,2380,72,186,53,40,13,59,105,30,53,52,4633,25.61823802,2282,356,41,0.409321177
Patty Mills,201988,2015-16,1662,81,226,46,31,15,79,76,40,22,54,3292,19.3960827,2969,388,35,0.347059309
Tony Parker,2225,2015-16,1980,72,379,83,61,22,105,131,48,54,77,3829,21.55898876,3825,764,70,0.552377278
LaMarcus Aldridge,200746,2015-16,2261,74,110,41,31,10,36,99,24,49,50,4375,26.15887278,2760,221,17,0.376133323
Danny Green,201980,2015-16,2062,79,141,33,18,15,48,75,31,31,44,3984,14.60699176,2618,265,28,0.275317507
Matt Bonner,2588,2015-16,206,30,9,4,3,1,4,3,1,1,2,395,14.41860465,288,19,0,0.333333333
Jonathon Simmons,203613,2015-16,813,55,58,26,20,6,14,53,18,26,27,1599,18.74647092,865,118,9,0.468068155
Manu Ginobili,1938,2015-16,1134,58,177,42,28,14,76,99,53,35,64,2268,23.23552736,1613,319,32,0.596918366
Tim Duncan,1495,2015-16,1536,61,163,28,19,9,83,90,39,34,56,2972,17.48210024,2068,273,9,0.449986835
Kevin Martin,2755,2015-16,1095,55,58,17,14,3,15,54,16,22,32,2191,22.21770918,848,133,14,0.29916075
Andre Miller,1889,2015-16,461,39,87,24,21,3,38,37,21,9,28,856,16.13236815,865,175,13,0.127058093
David West,2561,2015-16,1404,78,143,40,22,18,72,68,25,36,32,2749,17.95543906,1738,279,12,0.652267998
Boris Diaw,2564,2015-16,1386,76,176,58,44,14,63,97,35,43,54,2760,16.77038978,2227,328,22,0.552535234
Boban Marjanovic,1626246,2015-16,508,54,21,5,3,2,9,29,8,12,17,990,22.57777778,466,42,2,0.310736955
Jason Thompson,201574,2015-16,471,47,29,8,5,3,11,15,4,9,6,939,13.92285983,708,46,3,0.188505747
James Johnson,201949,2015-16,908,56,67,22,10,12,32,54,13,24,30,1764,16.19332337,728,133,6,0.616619709
Luis Scola,2449,2015-16,1617,75,66,29,20,9,25,68,19,31,37,3170,19.50678858,2287,147,11,0.458661371
DeMarre Carroll,201960,2015-16,786,26,27,15,9,6,8,28,11,7,21,1542,18.02358226,806,65,5,0.431860881
Cory Joseph,202709,2015-16,2011,79,250,102,72,30,80,102,31,39,63,3958,17.01134089,3592,547,38,0.613071143
Kyle Lowry,200768,2015-16,2804,76,494,152,82,70,219,225,94,90,135,5484,26.09526844,5039,927,49,0.732243029
Bismack Biyombo,202687,2015-16,1787,81,29,14,12,2,9,71,6,51,20,3432,11.81563535,1784,73,6,0.447643271
DeMar DeRozan,201942,2015-16,2764,77,315,160,109,51,104,175,52,65,110,5445,29.56746288,2944,672,33,0.766624869
Jonas Valanciunas,202685,2015-16,1527,59,42,22,16,6,14,85,10,61,24,3014,20.82000582,1862,81,6,0.526238675
Bruno Caboclo,203998,2015-16,43,6,1,1,1,0,0,4,2,2,2,89,15.53398058,43,5,0,0.5
Norman Powell,1626181,2015-16,722,48,47,23,14,9,12,32,10,16,16,1399,17.8125,592,82,3,0.496767772
Terrence Ross,203082,2015-16,1731,72,56,21,11,10,28,46,9,23,23,3356,18.28916295,1078,131,8,0.572200134
Patrick Patterson,202335,2015-16,1984,78,94,36,25,11,30,65,22,26,39,3865,13.04744526,2711,188,8,0.332899495
Delon Wright,1626153,2015-16,229,27,31,13,7,6,10,16,6,8,8,448,22.28796844,381,60,3,0.241935484
Lucas Nogueira,203512,2015-16,225,29,7,2,2,0,4,11,1,7,4,442,12.52525253,196,20,0,0.402597403
Joe Ingles,204060,2015-16,1241,81,96,27,18,9,54,65,34,28,37,2390,13.32110092,1657,227,9,0.640584648
Trey Burke,203504,2015-16,1366,64,148,46,24,22,67,80,35,28,52,2598,24.8502994,2366,345,27,0.611891462
Rodney Hood,203918,2015-16,2541,79,213,79,49,30,81,125,51,42,83,4724,21.92998703,2979,465,47,0.53559851
Shelvin Mack,202714,2015-16,1058,52,187,58,34,24,75,95,45,30,65,2027,23.25783972,2099,389,15,0.702827642
Alec Burks,202692,2015-16,797,31,63,20,11,9,32,51,19,24,27,1540,25.15510434,1008,154,3,0.661595274
Dante Exum,203957,2015-16,0,0,0,0,0,0,0,0,0,0,0,0,0,0,0,0,0
Derrick Favors,202324,2015-16,1983,62,94,43,27,16,32,104,34,53,51,3744,23.92982456,3060,222,10,0.485578077
Gordon Hayward,202330,2015-16,2893,80,296,112,57,55,124,202,63,87,115,5503,25.54140127,3618,712,32,0.717100099
Tibor Pleiss,202353,2015-16,82,12,2,1,1,0,1,8,1,6,2,156,19.54022989,106,10,2,0.583333333
Chris Johnson,203187,2015-16,0,0,0,0,0,0,0,0,0,0,0,0,0,0,0,0,0
Jeff Withey,203481,2015-16,658,51,20,13,11,2,3,28,7,16,12,1229,15.48893647,914,55,1,0.467571205
Raul Neto,203526,2015-16,1499,81,174,50,19,31,91,109,53,37,72,2805,17.61363636,2605,359,22,0.634132904
Rudy Gobert,203497,2015-16,1932,61,91,34,29,5,30,114,28,59,55,3613,14.61054669,2899,228,6,0.405804888
Trevor Booker,202344,2015-16,1632,79,83,42,25,17,23,81,22,48,33,3088,14.48179272,2825,235,9,0.541177666
Trey Lyles,1626168,2015-16,1382,80,59,36,24,12,14,65,19,36,29,2591,18.32139202,2171,169,5,0.565537198
Jared Dudley,201162,2015-16,2098,81,171,52,34,18,79,80,40,22,58,4240,12.98977853,3060,332,20,0.457824552
John Wall,202322,2015-16,2784,77,789,276,187,89,293,318,158,107,211,5699,28.39855414,5492,1602,70,1.033786744
Bradley Beal,203078,2015-16,1708,55,162,52,37,15,62,112,28,50,62,3504,25,1784,355,31,0.592683025
Markieff Morris,202693,2015-16,1629,64,124,45,31,14,52,135,41,72,63,3326,24.35522467,2066,266,8,0.585410748
Alan Anderson,101187,2015-16,192,13,14,3,1,2,8,2,2,0,2,388,15.63981043,133,19,0,0.119047619
Ramon Sessions,201196,2015-16,1667,82,239,60,50,10,91,115,45,50,65,3417,22.04828867,2506,496,30,0.605525505
Jarell Eddie,204067,2015-16,147,26,5,1,1,0,4,1,0,0,1,315,19.66292135,127,9,0,0.333333333
Kelly Oubre Jr.,1626162,2015-16,671,63,13,3,2,1,7,34,8,18,16,1389,17.08575113,494,36,5,0.405560451
Marcin Gortat,101162,2015-16,2256,75,106,33,26,7,39,121,29,66,55,4590,18.93147503,2429,206,17,0.370517418
Marcus Thornton,201977,2015-16,1108,61,84,24,15,9,53,51,21,19,32,2296,24.12466333,976,164,10,0.690230234
Garrett Temple,202066,2015-16,1951,80,140,40,29,11,48,64,26,22,42,3954,14.30530165,1759,289,15,0.388915156
JJ Hickson,201581,2015-16,437,35,23,8,5,3,7,25,10,10,15,899,22.35294118,570,48,2,0.11884058
Otto Porter Jr.,203490,2015-16,2276,75,120,29,19,10,62,70,20,34,36,4661,16.13645075,1886,222,15,0.46882041
Nene ,2403,2015-16,1094,57,97,20,10,10,50,76,20,35,41,2234,22.47933884,1246,198,6,0.5483873
Drew Gooden,2400,2015-16,305,30,13,5,4,1,2,13,6,4,9,626,17.40370899,410,38,3,-0.025641026
Jeff Teague,201952,2014-15,2228,73,513,158,112,46,200,205,87,77,128,4415,25.12685204,4034,1034,71,0.876806962
Austin Daye,201948,2014-15,344,34,17,3,1,2,8,23,7,12,11,687,21.5483871,421,29,4,0.1543052
Paul Millsap,200794,2014-15,2390,73,223,83,47,36,72,166,37,86,80,4707,23.64980102,3237,463,33,0.537848883
DeMarre Carroll,201960,2014-15,2189,70,118,49,37,12,37,75,26,39,36,4286,16.79151061,2525,249,29,0.447844658
Pero Antic,203544,2014-15,1037,63,49,22,14,8,16,49,18,24,25,2056,17.14778113,1190,80,6,0.416481347
Elton Brand,1882,2014-15,486,36,22,10,7,3,6,18,4,10,8,938,11.76470588,650,61,4,0.245791246
Shelvin Mack,202714,2014-15,833,55,155,42,31,11,57,49,24,14,35,1620,19.57964602,1493,327,18,0.678860232
John Jenkins,203098,2014-15,297,24,13,5,3,2,4,8,3,2,6,597,17.26726727,282,37,1,0.108974359
Al Horford,201143,2014-15,2318,76,244,116,63,53,81,100,28,50,50,4503,22.57612179,3223,415,29,0.615172722
Dennis Schroder,203471,2014-15,1516,77,317,127,93,34,80,150,61,58,92,2884,27.62550046,3072,673,51,0.778225987
Kent Bazemore,203145,2014-15,1324,75,78,30,25,5,33,73,18,33,40,2565,15.65005228,1378,167,19,0.539033634
Thabo Sefolosha,200757,2014-15,976,52,75,31,21,10,24,38,7,20,18,1854,14.78507322,1216,140,11,0.500679465
Kyle Korver,2594,2014-15,2418,75,196,34,23,11,103,107,49,46,61,4770,14.18560606,2124,329,26,0.46657439
Mike Muscala,203488,2014-15,502,40,25,9,5,4,8,21,1,15,6,980,16.31016043,736,62,7,0.459173678
Mike Scott,203118,2014-15,1123,68,75,33,22,11,25,39,10,23,16,2156,22.07792208,1331,119,12,0.498620487
Avery Bradley,202340,2014-15,2428,77,135,23,16,7,55,109,35,50,59,4891,20.97385032,1740,289,22,0.349136271
Isaiah Thomas,202738,2014-15,1726,67,284,128,87,41,86,143,39,53,90,3489,27.65957447,2803,643,33,0.812332318
Jared Sullinger,203096,2014-15,1566,58,134,53,29,24,44,78,21,45,33,3120,23.51789709,2262,274,9,0.545621436
Jonas Jerebko,201973,2014-15,1230,75,71,34,27,7,20,44,13,24,20,2366,16.44832606,1623,167,9,0.514383125
Evan Turner,202323,2014-15,2260,82,449,91,72,19,205,198,90,72,126,4501,19.63834338,3830,886,35,0.737155207
James Young,203923,2014-15,332,31,13,4,1,3,2,5,4,1,4,668,15.36491677,278,35,2,-0.138461538
Phil Pressey,203515,2014-15,600,50,117,43,34,9,43,41,12,23,18,1182,17.65140325,1150,255,16,0.902107069
Brandon Bass,101138,2014-15,1929,82,104,46,33,13,18,83,13,55,28,3790,19.99534992,2044,242,13,0.413450389
Marcus Smart,203935,2014-15,1808,67,208,55,43,12,85,90,40,26,64,3558,15.24674687,2365,425,34,0.517476941
Kelly Olynyk,203482,2014-15,1424,64,109,30,22,8,42,98,21,57,41,2888,21.06544901,2183,222,16,0.445355135
Tyler Zeller,203092,2014-15,1731,82,113,28,25,3,27,76,20,36,40,3441,19.91297671,1850,224,6,0.228439783
Gerald Wallace,2222,2014-15,286,32,11,4,4,0,4,18,7,9,9,554,9.291338583,296,41,2,0.227272727
Chris Babb,203569,2014-15,0,0,0,0,0,0,0,0,0,0,0,0,0,0,0,0,0
Gigi Datome,203540,2014-15,209,21,9,1,0,1,7,9,3,4,5,412,20.54507338,184,18,2,0.37037037
Jae Crowder,203109,2014-15,1647,82,94,35,27,8,38,49,19,25,24,3263,17.31430082,1858,217,16,0.52854406
Jarrett Jack,101127,2014-15,2241,80,373,94,63,31,156,191,84,66,125,4350,22.62147815,3581,805,34,0.702770045
Mason Plumlee,203486,2014-15,1743,82,74,21,13,8,31,106,20,58,48,3310,19.65811966,1706,186,12,0.434165501
Alan Anderson,101187,2014-15,1744,74,83,25,13,12,35,60,21,30,30,3385,14.22583181,1273,179,10,0.466141907
Joe Johnson,2207,2014-15,2791,80,292,89,49,40,100,137,57,45,92,5349,20.59018568,2927,585,42,0.499548293
Deron Williams,101114,2014-15,2114,68,448,113,79,34,167,154,71,51,103,4090,22.20782026,3878,930,50,0.748461595
Jerome Jordan,202366,2014-15,383,44,13,2,2,0,6,22,7,10,12,747,15.71594878,278,34,5,0.1002331
Sergey Karasev,203508,2014-15,555,33,46,12,7,5,17,24,8,14,10,1085,14.15857605,454,75,1,0.458545933
Brook Lopez,201572,2014-15,2100,72,50,21,13,8,12,104,16,55,49,4059,26.19669278,1516,134,11,0.32181541
Darius Morris,202721,2014-15,299,38,48,20,14,6,17,21,12,3,18,569,19.81707317,510,127,5,0.151785714
Cory Jefferson,203928,2014-15,531,50,16,6,3,3,7,20,4,6,14,1047,17.41988496,626,37,0,0.374618614
Markel Brown,203900,2014-15,781,47,39,12,7,5,16,27,11,10,17,1529,14.99148211,517,94,2,0.476915538
Thaddeus Young,201152,2014-15,2407,75,173,39,24,15,78,117,40,37,80,4758,21.52384433,3555,385,19,0.383295334
Mirza Teletovic,203141,2014-15,892,40,46,14,9,5,19,53,11,22,31,1724,20.12288786,1194,84,9,0.35361158
Bojan Bogdanovic,202711,2014-15,1854,78,68,23,15,8,23,78,18,35,43,3564,17.36763978,1141,158,9,0.383072737
Earl Clark,201947,2014-15,93,10,3,1,1,0,1,6,0,4,2,188,17.84037559,118,4,0,0.222222222
Lance Stephenson,202362,2014-15,1573,61,240,59,40,19,77,128,50,54,74,3042,21.00203903,2243,505,26,0.586812489
Marvin Williams,101107,2014-15,2035,78,100,27,22,5,36,60,19,36,24,3964,13.40252708,3679,210,13,0.323608165
Mo Williams,2590,2014-15,1967,67,424,67,36,31,195,172,86,57,115,3901,24.69273743,3658,848,52,0.724657016
Bismack Biyombo,202687,2014-15,1243,64,16,9,7,2,3,52,7,28,24,2348,11.69163318,512,45,2,0.386913873
Gerald Henderson,201945,2014-15,0,0,0,0,0,0,0,0,0,0,0,0,0,0,0,0,0
Noah Vonleh,203943,2014-15,259,25,4,1,1,0,1,11,3,5,6,498,17.06484642,399,28,0,-0.015151515
Michael Kidd-Gilchrist,203077,2014-15,1587,55,77,14,10,4,23,63,6,38,25,3036,18.39311334,1281,156,25,0.234989551
Kemba Walker,202689,2014-15,2119,62,318,70,51,19,117,100,37,32,68,4059,25.77097261,4120,698,65,0.526868451
PJ Hairston,203798,2014-15,687,45,21,6,4,2,8,22,7,11,11,1341,19.64056483,380,33,3,0.301543706
Brian Roberts,203148,2014-15,1330,72,162,52,36,16,46,57,30,17,40,2543,18.65929509,2338,331,30,0.428132985
Al Jefferson,2744,2014-15,1992,65,113,29,27,2,52,68,17,35,33,3845,26.87996263,1385,242,33,0.517931306
Troy Daniels,203584,2014-15,392,46,22,8,6,2,7,20,9,7,13,788,20.76086957,362,40,1,0.131818182
Cody Zeller,203469,2014-15,1487,62,100,16,14,2,38,62,27,29,33,2856,15.63169165,2581,176,11,0.215797048
Jeffery Taylor,203106,2014-15,430,29,22,6,3,3,8,19,5,9,10,820,16.39522258,263,51,5,0.127591707
Jason Maxiell,101131,2014-15,878,61,19,4,3,1,6,29,4,19,10,1690,12.95073641,649,53,3,0.220068491
Aaron Brooks,201166,2014-15,1885,82,261,81,48,33,94,157,70,59,98,3629,25.16826923,3172,616,46,0.650086505
Derrick Rose,201565,2014-15,1530,51,251,65,42,23,78,161,61,71,90,3013,31.05733218,2710,519,50,0.58078098
Doug McDermott,203926,2014-15,321,36,6,2,2,0,2,17,3,12,5,625,18.59799714,236,24,0,0.235294118
Kirk Hinrich,2550,2014-15,1610,66,148,39,27,12,50,73,43,25,48,3116,13.26105088,2097,316,26,0.395804692
Joakim Noah,201149,2014-15,2049,67,312,85,75,10,134,123,50,59,64,3955,13.81118881,3803,607,20,0.651000912
Pau Gasol,2200,2014-15,2681,78,210,85,64,21,85,158,61,56,102,5232,24.62102282,3640,482,22,0.573201848
Tony Snell,203503,2014-15,1412,72,62,19,12,7,30,48,23,18,30,2715,14.23979428,1092,134,18,0.466267387
Jimmy Butler,202710,2014-15,2513,65,212,68,43,25,67,93,32,44,49,4851,21.69491525,2375,434,43,0.483270671
Taj Gibson,201959,2014-15,1692,62,71,30,29,1,20,77,12,46,31,3211,17.88008565,1514,175,7,0.455708627
Mike Dunleavy,2399,2014-15,1838,63,114,26,21,5,49,60,21,23,37,3524,14.26802081,1648,213,16,0.364140254
Cameron Bairstow,203946,2014-15,64,18,1,0,0,0,0,3,0,3,0,127,12.92517007,67,7,0,-0.333333333
Nikola Mirotic,202703,2014-15,1654,82,97,31,22,9,43,89,28,40,49,3172,23.15963606,1961,173,9,0.438847883
Nazr Mohammed,1737,2014-15,128,23,3,1,1,0,1,7,3,4,3,247,13.4751773,137,6,1,0.19047619
E'Twaun Moore,202734,2014-15,504,56,33,11,8,3,14,14,7,6,8,973,14.50177936,475,76,7,0.544559885
Kevin Love,201567,2014-15,2493,74,168,30,21,9,98,122,42,50,72,4884,21.78182467,3375,308,20,0.446655305
James Jones,2592,2014-15,665,56,24,9,4,5,7,13,6,4,9,1306,15.69293478,709,47,3,0.239531344
Kyrie Irving,202681,2014-15,2687,74,389,129,85,44,185,186,72,64,122,5294,25.86974444,4153,773,64,0.729038554
Kendrick Perkins,2570,2014-15,1148,68,51,18,15,3,19,95,19,61,34,2243,13.98519673,1371,107,2,0.444109415
Iman Shumpert,202697,2014-15,1545,62,135,56,39,17,42,91,33,40,51,2917,17.68055139,1759,292,20,0.560779581
JR Smith,2747,2014-15,2079,70,195,66,45,21,73,97,50,30,67,4022,19.20486639,2200,351,26,0.477623253
Matthew Dellavedova,203521,2014-15,1365,66,204,78,58,20,79,61,39,16,45,2607,12.81456954,2274,419,26,0.681589394
Joe Harris,203925,2014-15,493,51,26,13,9,4,8,27,7,17,10,973,13.99817017,448,57,4,0.350902184
Tristan Thompson,202684,2014-15,2168,81,39,27,23,4,5,83,12,54,29,4159,14.1443299,1890,94,12,0.463807007
Anderson Varejao,2760,2014-15,636,26,35,7,5,2,25,35,6,21,14,1207,18.65889213,733,62,6,0.629687226
Mike Miller,2034,2014-15,675,51,46,13,11,2,16,23,13,9,14,1356,9.049479167,790,82,1,0.319481848
Timofey Mozgov,202389,2014-15,2046,81,55,21,18,3,16,116,17,64,52,3997,16.92640693,2036,113,16,0.300699351
LeBron James,2544,2014-15,2453,68,511,208,126,82,207,272,114,113,159,4805,32.37331389,3644,954,67,0.934658554
Shawn Marion,1890,2014-15,1082,56,51,17,11,6,15,33,12,15,18,2097,12.91377197,1088,89,15,0.276356019
Brendan Haywood,2217,2014-15,119,22,2,2,2,0,0,10,2,5,5,238,17.37451737,83,7,0,0.5
Amar'e Stoudemire,2405,2014-15,1236,58,45,14,11,3,9,78,5,43,35,2373,23.85861561,1345,98,4,0.180355608
Raymond Felton,101109,2014-15,281,29,41,20,13,7,14,18,7,9,9,565,20.46875,436,103,5,0.329268293
Charlie Villanueva,101111,2014-15,678,64,19,6,4,2,7,28,8,13,15,1390,26.05633803,831,33,4,0.260689522
Greg Smith,202962,2014-15,0,0,0,0,0,0,0,0,0,0,0,0,0,0,0,0,0
J.J. Barea,200826,2014-15,1362,77,263,72,55,17,117,70,35,22,48,2664,21.60186108,2431,538,22,0.773041863
Tyson Chandler,2199,2014-15,2286,75,84,13,10,3,24,105,20,62,43,4534,12.88810779,2157,189,12,0.140933783
Al-Farouq Aminu,202329,2014-15,1366,74,59,25,17,8,22,55,15,31,24,2693,15.07782101,1368,135,7,0.515335198
Dwight Powell,203939,2014-15,236,29,9,5,3,2,2,11,2,5,6,482,16.90647482,287,19,0,0.262626263
Rajon Rondo,200765,2014-15,2019,68,538,164,110,54,196,210,113,74,136,4075,19.45355191,4343,1038,37,0.873059827
Monta Ellis,101145,2014-15,2699,80,329,132,103,29,140,198,83,68,130,5422,27.6746097,3245,713,71,0.758453734
Devin Harris,2734,2014-15,1685,76,237,77,50,27,110,85,36,38,47,3345,18.03538421,2670,469,26,0.725376187
Richard Jefferson,2210,2014-15,1244,74,61,24,19,5,17,52,17,27,25,2459,15.549112,1179,126,6,0.386697807
Chandler Parsons,202718,2014-15,2186,66,161,52,32,20,71,96,28,34,62,4355,20.42224929,2553,368,31,0.527852196
Dirk Nowitzki,1717,2014-15,2282,77,143,53,32,21,67,82,31,30,52,4502,25.128611,2745,262,15,0.504703227
Bernard James,203108,2014-15,158,16,4,1,1,0,0,6,0,3,3,309,12.18836565,106,9,0,-0.25
Darrell Arthur,201589,2014-15,988,58,57,19,12,7,25,47,19,21,26,1991,20.37201063,988,131,4,0.519381514
Ty Lawson,201951,2014-15,2665,75,720,225,160,65,287,185,103,50,135,5386,20.56646283,4653,1506,54,1.023299877
Randy Foye,200751,2014-15,1087,50,119,32,20,12,58,60,34,19,41,2188,19.40657578,1021,266,9,0.700430515
Will Barton,203115,2014-15,984,58,81,25,14,11,31,61,21,22,39,1960,20.15024304,1015,184,13,0.513182595
JJ Hickson,201581,2014-15,1411,73,57,26,16,10,18,96,25,53,43,2802,20.07446478,1482,116,8,0.449774738
Danilo Gallinari,201568,2014-15,1426,59,83,25,20,5,42,57,28,21,36,2846,21.80474284,1269,198,11,0.558247565
Erick Green,203475,2014-15,410,43,39,10,8,2,15,14,3,9,5,818,18.56410256,559,85,7,0.188644689
Gary Harris,203914,2014-15,719,55,29,7,6,1,12,38,9,23,15,1469,16.31205674,420,93,6,0.541035019
Ian Clark,203546,2014-15,192,30,12,6,2,4,5,9,5,2,7,375,15.63218391,195,34,3,0.324074074
Wilson Chandler,201163,2014-15,2471,78,134,54,38,16,50,110,35,54,56,4917,20.11959198,2410,332,23,0.545206995
Jamaal Franklin,203479,2014-15,13,3,3,1,0,1,2,3,1,2,1,31,13.51351351,22,7,0,0.555555556
Jusuf Nurkic,203994,2014-15,1103,62,50,15,13,2,27,86,16,52,34,2213,20.74882995,1255,118,10,0.575888586
Jameer Nelson,2749,2014-15,1406,63,253,73,51,22,110,109,44,44,65,2768,19.8482933,2386,546,30,0.808380641
Kenneth Faried,202702,2014-15,2086,75,89,26,23,3,44,118,35,59,59,4147,20.29015544,2046,192,10,0.472400682
Joffrey Lauvergne,203530,2014-15,268,24,13,5,5,0,3,22,8,9,13,537,19.0625,276,29,0,0.085081585
Andre Drummond,203083,2014-15,2502,82,55,17,13,4,29,120,18,80,40,4827,22.05700124,1313,103,7,0.511532564
Reggie Jackson,202704,2014-15,2268,77,462,131,85,46,190,186,81,68,118,4389,24.97059976,3606,956,52,0.836632782
Shawne Williams,200761,2014-15,1060,62,44,15,9,6,12,30,10,17,13,2028,15.28021016,1409,89,7,0.282986216
Kentavious Caldwell-Pope,203484,2014-15,2587,82,109,35,25,10,46,94,26,41,53,5023,19.33833561,1908,211,19,0.413991327
Brandon Jennings,201943,2014-15,1173,41,272,73,47,26,120,90,48,26,64,2316,25.43182653,2237,546,42,0.848738488
Spencer Dinwiddie,203915,2014-15,455,34,104,36,27,9,39,33,13,17,16,863,21.54915591,841,205,7,0.226204351
John Lucas III,101249,2014-15,272,21,60,17,10,7,10,16,8,4,12,516,21.18055556,545,133,7,-0.133333333
Greg Monroe,202328,2014-15,2137,69,142,52,38,14,64,149,33,65,84,4096,23.96591145,2312,350,13,0.610813696
Jodie Meeks,201975,2014-15,1462,60,79,21,11,10,32,57,18,22,35,2845,20.05486132,890,172,10,0.443779866
Tayshaun Prince,2419,2014-15,1397,58,93,22,17,5,38,35,10,17,18,2628,15.40237467,1625,218,14,0.430601907
Caron Butler,2406,2014-15,1623,78,79,26,14,12,30,49,25,21,28,3095,13.21499014,1875,161,6,0.370116917
Quincy Miller,203113,2014-15,120,10,8,3,3,0,4,5,1,2,3,245,16.66666667,123,14,0,0.341666667
Cartier Martin,201858,2014-15,198,23,11,6,3,3,4,5,0,4,1,379,12.80353201,147,18,3,0.509090909
Anthony Tolliver,201229,2014-15,1433,76,59,16,13,3,27,51,17,32,19,2803,14.79974969,1756,124,12,0.428444005
Joel Anthony,201202,2014-15,406,49,5,3,2,1,1,12,1,10,2,774,9.464082098,193,16,2,0.411111111
Ognjen Kuzmic,203136,2014-15,72,16,6,3,3,0,2,5,3,2,3,155,11.17647059,100,14,0,0.3
Brandon Rush,201575,2014-15,271,33,12,4,3,1,5,11,4,5,6,572,10.95461659,271,27,0,0.234848485
Marreese Speights,201578,2014-15,1207,76,72,16,12,4,33,82,16,48,34,2490,28.96995708,1315,140,13,0.431464776
Justin Holiday,203200,2014-15,657,59,48,12,10,2,22,29,16,8,21,1333,18.84538819,576,79,10,0.391016999
Andre Iguodala,2738,2014-15,2069,77,228,71,46,25,95,88,41,34,54,4174,13.45091373,2554,440,21,0.575133288
David Lee,101135,2014-15,904,49,85,36,28,8,26,49,14,21,28,1821,19.80676329,1446,175,16,0.520209825
Klay Thompson,202691,2014-15,2455,77,222,61,41,20,108,149,55,52,97,5060,27.53444013,1779,405,40,0.603551127
Andrew Bogut,101106,2014-15,1583,67,180,65,48,17,66,106,34,56,50,3212,13.29802063,2176,333,19,0.600604904
Leandro Barbosa,2571,2014-15,982,66,99,33,23,10,37,44,16,14,30,1981,20.62222222,1017,188,9,0.522768099
James Michael McAdoo,203949,2014-15,137,15,2,0,0,0,1,6,2,1,5,281,19.04761905,207,10,2,-0.111111111
Draymond Green,203110,2014-15,2490,79,291,116,76,40,109,133,51,59,74,5139,17.12995136,3951,506,35,0.585680579
Stephen Curry,201939,2014-15,2613,80,619,184,115,69,281,249,125,82,167,5447,28.14439726,4328,1083,54,0.859014573
Festus Ezeli,203105,2014-15,504,46,9,6,6,0,1,32,3,19,13,1009,17.88478074,513,27,5,0.415230785
Shaun Livingston,2733,2014-15,1468,78,259,74,57,17,94,102,36,46,56,2921,16.3630844,2769,478,27,0.630547355
Harrison Barnes,203084,2014-15,2318,82,116,45,36,9,38,71,21,29,42,4750,14.96329757,2142,229,27,0.390702302
Trevor Ariza,2772,2014-15,2896,81,209,92,48,44,80,141,51,70,71,5838,16.62938106,3258,464,29,0.62442413
Patrick Beverley,201976,2014-15,1727,56,192,75,54,21,76,83,42,33,50,3440,16.29142423,2880,388,25,0.611711062
Nick Johnson,203910,2014-15,258,27,11,3,2,1,8,19,6,12,7,530,17.43421053,250,43,4,0.543859649
Josh Smith,2746,2014-15,2301,83,277,119,54,65,136,206,76,91,115,4625,24.73584906,2802,531,17,0.821436867
Terrence Jones,203093,2014-15,889,33,36,18,11,7,13,37,6,20,17,1774,18.87450199,914,93,6,0.580987095
Joey Dorsey,201595,2014-15,851,68,25,9,6,3,13,41,8,29,12,1727,11.13300493,912,74,6,0.617202564
Pablo Prigioni,203143,2014-15,1192,66,171,55,43,12,60,62,38,18,44,2324,11.70454545,2280,389,19,0.599578464
Dwight Howard,2730,2014-15,1189,40,50,26,20,6,17,115,20,69,46,2429,23.59268555,1402,94,11,0.539438441
James Harden,201935,2014-15,2941,80,565,250,119,131,246,321,130,119,202,5971,31.28825415,3765,1129,73,1.018531841
Clint Capela,203991,2014-15,90,12,2,1,1,0,1,5,3,1,4,189,21.32701422,92,5,0,0.4
Kostas Papanikolaou,203123,2014-15,771,42,85,35,23,12,42,55,29,12,43,1585,14.40443213,1008,164,10,0.687352137
Donatas Motiejunas,202700,2014-15,2006,70,130,56,38,18,53,123,36,64,59,4024,19.39106025,2792,285,16,0.589387749
Jason Terry,1891,2014-15,1618,76,147,51,32,19,71,74,35,27,47,3328,14.04199475,2237,371,17,0.680029471
KJ McDaniels,203909,2014-15,1352,62,72,21,15,6,32,105,34,47,58,2685,19.37984496,1006,138,13,0.457898738
Corey Brewer,201147,2014-15,2063,79,173,50,36,14,81,130,47,56,74,4302,21.02169065,1805,350,25,0.597710169
CJ Miles,101139,2014-15,1841,70,75,20,14,6,28,73,33,29,44,3627,23.49368319,1467,175,15,0.320101529
Rodney Stuckey,201155,2014-15,1874,71,219,68,37,31,56,118,48,49,69,3620,23.40787555,2315,465,37,0.486957726
George Hill,201588,2014-15,1267,43,220,59,41,18,40,69,30,26,43,2438,24.35100548,2301,459,54,0.470688772
Luis Scola,2449,2014-15,1659,81,105,38,29,9,37,94,32,36,58,3239,22.6681128,2598,260,11,0.432076521
Lavoy Allen,202730,2014-15,1070,63,73,23,18,5,29,40,13,18,22,2049,15.12992456,1377,166,11,0.471354212
Damjan Rudez,204014,2014-15,1047,68,53,24,14,10,16,47,20,24,23,2047,13.73224279,881,136,9,0.542528052
Paul George,202331,2014-15,91,6,6,1,0,1,0,12,2,8,4,173,32.67326733,81,10,1,-0.277777778
Donald Sloan,202388,2014-15,1107,53,190,58,39,19,32,65,28,20,45,2132,18.53817885,2225,483,33,0.562974661
David West,2561,2014-15,1895,66,223,64,36,28,83,120,45,54,66,3690,21.13352546,2998,470,15,0.547318447
Chris Copeland,203142,2014-15,828,50,51,15,11,4,14,59,19,26,33,1597,21.12753147,703,110,5,0.338175943
Ian Mahinmi,101133,2014-15,1146,61,33,12,9,3,10,59,10,42,17,2192,12.50996016,1181,109,9,0.424696239
C.J. Watson,201228,2014-15,1422,57,208,52,38,14,51,100,42,39,61,2793,18.54660348,2613,437,33,0.433080003
Shayne Whittington,203963,2014-15,108,20,6,2,1,1,4,5,0,4,1,211,24.68085106,138,9,1,0.6
Solomon Hill,203524,2014-15,2381,82,184,59,40,19,45,115,52,44,71,4556,16.19433198,2411,395,37,0.355816073
Roy Hibbert,201579,2014-15,1926,76,84,22,15,7,45,107,24,54,53,3654,22.01879065,1872,186,19,0.495108863
Glen Davis,201175,2014-15,904,74,39,17,12,5,8,39,6,26,13,1758,17.40473738,842,89,2,0.400733237
Jordan Hamilton,202706,2014-15,122,14,7,2,1,1,1,4,3,1,3,245,14.44444444,87,15,0,-0.154761905
Chris Paul,101108,2014-15,2857,82,838,232,156,76,328,190,88,71,119,5649,23.50827866,5791,1649,127,0.988083554
JJ Redick,200755,2014-15,2409,78,137,43,29,14,66,95,33,44,51,4780,20.39948215,1855,267,61,0.538109417
DeAndre Jordan,201599,2014-15,2820,82,61,22,18,4,19,109,23,61,48,5509,13.63925056,3199,109,14,0.264734454
Spencer Hawes,201150,2014-15,1274,73,88,39,29,10,24,61,14,34,27,2468,18.70397644,1733,165,11,0.459758735
Jamal Crawford,2037,2014-15,1703,64,158,52,35,17,73,92,36,33,59,3358,27.63509898,1551,283,25,0.592678052
Ekpe Udoh,202327,2014-15,128,33,8,5,5,0,2,7,2,3,4,261,12.36749117,135,18,1,0.351190476
Lester Hudson,201991,2014-15,56,5,5,3,3,0,1,3,3,0,3,106,16.37931034,96,12,2,0.133333333
Hedo Turkoglu,2045,2014-15,705,62,37,21,11,10,5,29,11,11,18,1379,14.69225678,719,69,4,0.356311778
Matt Barnes,2440,2014-15,2271,76,114,35,26,9,50,87,36,40,47,4473,14.83009232,1906,197,18,0.422307818
Austin Rivers,203085,2014-15,1563,76,155,56,41,15,56,65,27,21,44,3015,17.9889567,1868,344,9,0.567850033
CJ Wilcox,203912,2014-15,101,21,8,3,3,0,2,10,5,2,8,208,21.14537445,80,14,0,0.025
Dahntay Jones,2563,2014-15,123,33,2,1,1,0,1,1,0,1,0,244,9.854014599,71,14,2,0.666666667
Blake Griffin,201933,2014-15,2356,67,354,144,89,55,116,152,47,62,90,4646,28.26169646,3724,656,34,0.658354225
Nick Young,201156,2014-15,1000,42,41,7,6,1,19,44,11,16,28,1976,25.45374059,582,87,9,0.325176332
Wayne Ellington,201961,2014-15,1675,65,105,23,16,7,44,50,20,16,34,3261,18.61088764,1250,231,12,0.400805686
Ryan Kelly,203527,2014-15,1233,52,92,29,20,9,28,37,12,15,22,2369,14.27514793,1220,171,8,0.366883752
Carlos Boozer,2430,2014-15,1692,71,95,20,16,4,33,92,21,50,42,3335,23.60965373,2075,212,11,0.299851673
Jordan Clarkson,203903,2014-15,1476,59,206,42,30,12,94,96,30,34,62,2842,23.41927563,2208,417,18,0.582962085
Ronnie Price,101179,2014-15,982,43,165,36,23,13,57,52,23,15,37,1920,13.47291761,1729,344,14,0.542387978
Wesley Johnson,202325,2014-15,2245,76,124,25,19,6,50,87,33,37,50,4426,16.33986928,1693,221,8,0.308912982
Vander Blue,203505,2014-15,74,2,8,2,1,1,3,6,3,3,3,152,20.32085561,79,19,0,0.125
Jabari Brown,203913,2014-15,568,19,40,14,11,3,12,32,11,10,22,1113,18.70615744,442,77,6,0.397271525
Jeremy Lin,202391,2014-15,1907,74,339,55,35,20,165,166,69,55,111,3777,21.96478221,2839,691,23,0.698487453
Ed Davis,202334,2014-15,1840,79,94,30,24,6,31,58,10,28,30,3575,14.73149492,2125,193,13,0.338903878
Kobe Bryant,977,2014-15,1207,35,197,47,29,18,87,128,50,54,74,2402,34.18181818,1334,434,16,0.83906789
Jordan Hill,201941,2014-15,1874,70,103,28,24,4,33,106,23,46,60,3697,22.64685067,2285,228,9,0.291666501
Tarik Black,204028,2014-15,1178,62,42,15,13,2,10,48,5,33,15,2287,14.18332705,1288,100,3,0.32026749
Julius Randle,203944,2014-15,14,1,0,0,0,0,0,1,1,0,1,24,17.85714286,11,1,0,0
Robert Sacre,203135,2014-15,1133,67,55,21,20,1,10,36,10,20,16,2201,15.25559105,1137,135,3,0.320041083
JaMychal Green,203210,2014-15,164,24,4,1,0,1,3,14,4,10,4,328,17.27748691,150,11,0,0.571428571
Jarnell Stokes,203950,2014-15,126,19,4,0,0,0,4,7,1,4,3,254,19.06354515,119,13,1,0.523809524
Russ Smith,203893,2014-15,65,12,8,3,3,0,4,12,3,8,4,136,25.74850299,96,15,0,0.430555556
Jordan Adams,203919,2014-15,248,30,16,1,1,0,9,14,4,6,8,486,19.23076923,183,31,2,0.101190476
Courtney Lee,201584,2014-15,2354,77,151,34,25,9,45,78,32,35,43,4503,15.08357915,2311,302,34,0.265056419
Tony Allen,2754,2014-15,1648,63,86,14,7,7,47,86,27,36,50,3150,16.60639777,1226,168,13,0.421143285
Mike Conley,201144,2014-15,2225,70,375,54,29,25,162,156,83,43,113,4250,23.68911917,4276,813,61,0.556737897
Nick Calathes,201979,2014-15,838,58,146,26,21,5,64,61,35,22,39,1597,17.64705882,1520,299,18,0.623502704
Vince Carter,1713,2014-15,1091,66,79,11,7,4,40,42,18,21,21,2109,19.87447699,1179,143,14,0.397931259
Beno Udrih,2757,2014-15,1494,79,220,57,39,18,82,89,46,24,65,2854,19.67871486,2926,499,51,0.559581819
Jon Leuer,202720,2014-15,824,63,46,9,6,3,19,35,20,9,26,1577,18.76046901,1022,102,7,0.251333984
Jeff Green,201145,2014-15,2455,78,134,35,20,15,44,108,28,59,49,4791,22.18940373,2407,295,27,0.347706473
Marc Gasol,201188,2014-15,2687,81,307,73,45,28,155,176,50,86,90,5129,24.88352028,3889,636,30,0.639116515
Kosta Koufos,201585,2014-15,1348,81,37,8,4,4,8,69,10,43,26,2554,15.90057882,1490,98,5,0.111967343
Zach Randolph,2216,2014-15,2304,71,153,45,39,6,58,156,43,80,76,4392,24.36102236,2501,353,17,0.471831467
Chris Bosh,2547,2014-15,1556,44,95,23,15,8,35,95,19,42,53,2911,28.90120037,1840,187,9,0.313038454
Dwyane Wade,2548,2014-15,1934,61,299,91,53,38,143,209,83,79,130,3734,34.53596012,2426,624,34,0.821799722
Josh McRoberts,201177,2014-15,296,17,33,4,4,0,19,22,10,9,13,542,13.32236842,458,72,6,0.166666667
Henry Walker,201611,2014-15,628,24,29,6,3,3,14,24,5,17,7,1215,14.54545455,824,74,2,0.466739837
Goran Dragic,201609,2014-15,2640,78,350,112,69,43,146,173,78,60,113,5261,21.45020188,3986,762,50,0.665888582
Tyler Johnson,204020,2014-15,603,32,42,14,9,5,16,30,7,11,19,1183,16.64145234,725,123,6,0.543476542
Luol Deng,2736,2014-15,2381,71,139,43,28,15,52,108,43,37,71,4577,19.59798995,2090,288,21,0.389740726
Chris Andersen,2365,2014-15,1103,59,43,6,4,2,23,40,14,17,23,2129,12.72189349,1046,85,6,0.307743112
Zoran Dragic,204054,2014-15,75,16,5,1,0,1,4,5,2,3,2,154,21.14285714,62,12,2,0.533333333
Shabazz Napier,203894,2014-15,1012,51,130,48,27,21,40,81,38,31,50,1873,15.87901701,1846,302,16,0.599844365
Mario Chalmers,201596,2014-15,2337,79,307,97,56,41,131,173,64,79,94,4494,18.82050267,3881,678,35,0.693032918
Hassan Whiteside,202355,2014-15,1134,47,6,2,2,0,3,58,13,37,21,2171,20.53750501,965,29,4,0.434935351
Michael Beasley,201563,2014-15,505,24,32,10,7,3,16,37,16,16,21,975,24.20856611,566,63,4,0.526037373
James Ennis III,203516,2014-15,1051,62,48,18,11,7,20,39,15,18,21,1967,14.64285714,747,105,8,0.519313255
Udonis Haslem,2617,2014-15,982,61,46,13,9,4,20,41,15,20,21,1862,14.50023463,1247,98,2,0.39171121
O.J. Mayo,201564,2014-15,1673,70,197,35,19,16,112,128,44,65,63,3363,23.59042553,1487,359,24,0.704807328
Johnny O'Bryant III,203948,2014-15,358,33,17,6,1,5,4,25,4,14,11,713,19.30693069,340,27,0,0.108235294
Michael Carter-Williams,203487,2014-15,2150,66,442,135,113,22,170,253,107,77,176,4240,26.93658335,4115,945,46,0.794010372
Ersan Ilyasova,101141,2014-15,1307,57,56,20,14,6,22,45,13,22,23,2583,21.99730094,1394,122,6,0.427157765
Jared Dudley,201162,2014-15,1694,71,130,43,22,21,51,62,28,29,33,3332,13.77101681,2258,277,23,0.498517468
Tyler Ennis,203898,2014-15,411,33,73,22,16,6,26,42,25,10,32,818,20.25723473,736,134,10,0.070232659
Jabari Parker,203953,2014-15,738,25,42,10,5,5,24,47,14,17,30,1464,20.55622733,663,78,5,0.486762634
Jorge Gutierrez,203268,2014-15,174,20,22,2,1,1,10,12,4,8,4,342,14.94845361,267,57,3,0.101010101
Damien Inglis,203996,2014-15,0,0,0,0,0,0,0,0,0,0,0,0,0,0,0,0,0
Jerryd Bayless,201573,2014-15,1700,76,233,68,46,22,79,133,55,57,76,3313,18.87346503,2644,530,49,0.619310327
Miles Plumlee,203101,2014-15,1194,73,34,14,11,3,7,51,15,27,24,2346,12.31174699,1286,60,5,0.224358535
Khris Middleton,203114,2014-15,2345,78,182,39,23,16,88,113,45,43,70,4647,19.75821685,2328,374,33,0.478120383
Zaza Pachulia,2585,2014-15,1702,72,178,35,25,10,86,133,39,61,72,3382,18.99585921,1833,346,20,0.55804266
John Henson,203089,2014-15,1211,66,59,15,7,8,27,87,20,48,39,2361,18.49775785,1040,116,11,0.436432852
Giannis Antetokounmpo,203507,2014-15,2508,80,207,73,43,30,81,173,37,105,68,4940,19.70128023,2843,427,24,0.600055466
Adreian Payne,203940,2014-15,740,32,30,6,4,2,9,44,9,25,19,1417,17.73093614,948,83,1,0.222442178
Robbie Hummel,203133,2014-15,733,44,27,9,7,2,12,18,10,6,12,1438,12.28175798,1014,73,3,0.393805056
Gorgui Dieng,203476,2014-15,2179,72,146,31,26,5,61,126,28,67,59,4295,15.16990291,1878,324,18,0.461935019
Lorenzo Brown,203485,2014-15,549,29,90,29,17,12,25,30,11,13,17,1045,13.63251482,959,186,6,0.610527625
Zach LaVine,203897,2014-15,1867,76,276,40,31,9,99,193,89,59,134,3727,22.33238905,3186,599,39,0.447701958
Ricky Rubio,201937,2014-15,692,22,193,31,22,9,78,64,36,18,46,1382,19.6762142,1435,405,15,0.859340253
Chase Budinger,201978,2014-15,1282,66,64,12,12,0,28,49,22,19,30,2543,16.45127489,1179,157,10,0.343213631
Gary Neal,202390,2014-15,1192,54,100,35,27,8,26,65,26,30,35,2319,23.79679144,1213,223,11,0.468101739
Nikola Pekovic,201593,2014-15,787,30,27,4,3,1,13,41,7,24,17,1593,22.85867238,478,81,8,0.430463472
Shabazz Muhammad,203498,2014-15,851,37,44,8,6,2,18,35,11,16,19,1720,24.47968285,444,69,4,0.313109863
Kevin Garnett,708,2014-15,952,47,77,22,18,4,35,46,16,26,20,1813,18.37944664,1620,159,7,0.527163826
Andrew Wiggins,203952,2014-15,2937,81,170,40,29,11,72,177,47,79,98,5805,22.7374385,1912,386,22,0.474242228
Kevin Martin,2755,2014-15,1280,38,89,12,10,2,33,76,26,33,43,2585,26.55137335,969,167,12,0.286499524
Anthony Bennett,203461,2014-15,885,56,48,13,10,3,22,36,7,20,16,1781,17.69005848,1343,91,4,0.418268793
Justin Hamilton,203120,2014-15,713,41,36,10,6,4,10,26,9,10,16,1366,14.70588235,768,75,2,0.219939608
Arinze Onuaku,202620,2014-15,68,6,4,2,1,1,1,2,0,2,0,133,12.82051282,48,6,0,0.416666667
Tyreke Evans,201936,2014-15,2690,79,521,184,128,56,195,246,94,103,143,5131,25.82159624,4152,1095,47,0.871138467
Omer Asik,201600,2014-15,1982,76,72,24,17,7,23,95,15,59,36,3731,14.06141769,2292,117,5,0.303207057
Jeff Withey,203481,2014-15,259,37,11,5,4,1,2,12,2,6,6,495,17.79359431,271,24,1,0.136363636
Luke Babbitt,202337,2014-15,830,63,24,8,8,0,9,26,12,6,20,1608,12.54836926,776,55,2,0.255731092
Eric Gordon,201569,2014-15,2018,61,229,47,26,21,101,122,46,46,76,3829,19.83677171,1760,466,30,0.600999035
Jrue Holiday,201950,2014-15,1303,40,274,55,38,17,136,91,43,30,61,2538,22.64736298,2176,506,14,0.761175112
Toney Douglas,201962,2014-15,177,12,24,7,4,3,11,10,5,4,6,328,18.45730028,196,38,2,0.216666667
Quincy Pondexter,202347,2014-15,1793,75,94,16,11,5,50,51,17,25,26,3396,13.85604113,1469,181,17,0.423020887
Anthony Davis,203076,2014-15,2455,68,149,56,39,17,66,95,15,58,37,4708,27.52310536,2391,271,11,0.579362715
Norris Cole,202708,2014-15,1798,74,255,80,57,23,79,99,38,47,52,3394,18.37652036,3285,544,40,0.583271519
Jimmer Fredette,202690,2014-15,509,50,58,16,15,1,28,33,10,12,21,996,18.73373807,523,121,3,0.682244718
Ryan Anderson,201583,2014-15,1675,61,55,16,12,4,21,62,12,31,31,3207,23.02507414,1634,127,6,0.326271546
Alexis Ajinca,201582,2014-15,957,68,47,6,5,1,20,69,11,39,30,1794,21.50485437,894,93,3,0.276136149
Dante Cunningham,201967,2014-15,1652,66,50,13,11,2,21,35,10,20,15,3073,11.23085649,1427,100,8,0.334419296
Shane Larkin,203499,2014-15,1845,75,226,66,52,14,61,83,46,19,64,3496,13.77155711,3409,562,39,0.441050232
Alexey Shved,203144,2014-15,767,42,106,22,16,6,40,48,23,15,33,1516,25.89182969,1210,266,8,0.589046108
Langston Galloway,204038,2014-15,1429,44,150,41,30,11,38,61,30,23,38,2788,19.05511811,2405,320,24,0.342672013
Jose Calderon,101181,2014-15,1233,41,198,50,36,14,55,75,54,11,64,2428,16.01590745,2508,395,28,0.390378118
Quincy Acy,203112,2014-15,1283,67,68,22,19,3,18,60,19,23,37,2437,15.51662496,1565,162,7,0.279127345
Tim Hardaway Jr.,203501,2014-15,1656,69,127,23,17,6,46,82,28,30,52,3206,23.55992356,2198,259,15,0.272827001
Travis Wear,204037,2014-15,651,50,40,14,14,0,14,35,14,12,23,1261,17.91462561,819,111,4,0.453657096
Carmelo Anthony,2546,2014-15,1400,39,122,40,31,9,39,89,23,52,37,2691,32.32421875,1657,235,13,0.485310585
Ricky Ledo,203495,2014-15,244,17,19,7,4,3,7,26,12,8,18,475,24.04371585,351,60,5,0.172739541
Jason Smith,201160,2014-15,1770,81,140,46,38,8,39,104,31,52,52,3400,19.86566779,2526,301,11,0.396360083
Cleanthony Early,203921,2014-15,647,39,36,12,9,3,6,40,18,17,23,1248,19.67213115,881,74,10,0.173369494
Lou Amundson,200811,2014-15,920,52,70,11,9,2,18,62,17,34,28,1784,17.71400297,1332,155,9,0.215259374
Lance Thomas,202498,2014-15,1473,61,69,25,21,4,13,74,21,40,34,2830,17.29346486,1483,154,8,0.272630252
Cole Aldrich,202332,2014-15,962,60,75,14,9,5,31,59,24,29,30,1859,18.2932579,1602,171,5,0.381671392
Andrea Bargnani,200745,2014-15,785,29,46,7,6,1,19,42,12,16,26,1510,26.35885447,905,105,6,0.275314913
Russell Westbrook,201566,2014-15,2302,67,574,147,93,54,259,293,130,101,192,4708,37.25703906,3691,1118,29,0.944117289
Anthony Morrow,201627,2014-15,1806,74,60,19,11,8,27,38,10,19,19,3643,16.31003329,1044,110,8,0.432938736
Perry Jones III,203103,2014-15,631,43,18,9,5,4,5,24,6,13,11,1250,15.59440559,527,53,1,0.476229587
Nick Collison,2555,2014-15,1101,66,90,26,17,9,41,45,17,24,21,2165,13.06089744,1749,188,6,0.53379941
Kyle Singler,202713,2014-15,1744,80,85,28,17,11,29,55,22,21,34,3413,13.13485114,1650,154,10,0.312830382
Steve Novak,200779,2014-15,197,35,11,5,5,0,4,5,2,2,3,407,13.19148936,219,14,1,0.284848485
Serge Ibaka,201586,2014-15,2116,64,55,23,16,7,23,97,16,60,37,4175,19.31205968,2653,122,9,0.479524168
Jeremy Lamb,203087,2014-15,633,47,44,12,9,3,15,27,13,10,17,1218,21.67630058,510,89,6,0.385536607
Steven Adams,203500,2014-15,1771,70,66,27,20,7,14,99,19,56,43,3475,14.50700762,1747,174,6,0.340946533
D.J. Augustin,201571,2014-15,1964,82,353,121,84,37,137,145,68,51,94,3829,19.81110861,3367,793,50,0.820741956
Andre Roberson,203460,2014-15,1286,67,70,25,18,7,20,46,20,20,26,2558,9.027081244,1125,129,13,0.336095721
Dion Waiters,203079,2014-15,2180,79,163,62,37,25,58,113,40,47,66,4405,22.22657014,1628,337,22,0.569762333
Mitch McGary,203956,2014-15,485,32,14,6,4,2,7,31,7,14,17,990,18.55400697,596,33,2,0.412442396
Enes Kanter,202683,2014-15,2136,75,55,22,13,9,16,145,26,83,62,4140,24.20618557,3011,156,6,0.33989076
Kevin Durant,201142,2014-15,913,27,110,30,17,13,47,74,34,20,54,1856,28.34572491,926,216,13,0.593267457
Aaron Gordon,203932,2014-15,797,47,33,14,9,5,14,38,10,21,17,1527,15.63218391,766,75,6,0.558042821
Kyle O'Quinn,203124,2014-15,824,51,59,11,8,3,33,55,23,29,26,1580,18.53770869,1216,124,9,0.507312742
Dewayne Dedmon,203473,2014-15,845,59,9,1,1,0,6,51,9,32,19,1616,12.89978678,611,29,1,0.40204414
Elfrid Payton,203901,2014-15,2489,82,533,136,89,47,202,203,93,80,123,4849,18.26748822,4255,1086,45,0.790391514
Victor Oladipo,203506,2014-15,2573,72,295,83,52,31,98,204,70,79,125,5028,25.31244499,3024,608,33,0.513335863
Ben Gordon,2732,2014-15,790,56,50,8,7,1,23,55,20,24,31,1529,22.10587551,534,107,13,0.434605449
Channing Frye,101112,2014-15,1870,75,94,22,13,9,44,78,24,48,30,3660,14.09756098,3042,190,8,0.404652385
Nikola Vucevic,202696,2014-15,2529,74,147,63,44,19,60,148,31,85,63,4963,25.84730646,2365,357,21,0.653623358
Evan Fournier,203095,2014-15,1661,58,120,40,25,15,40,82,25,33,49,3221,20.07786429,1390,260,23,0.477728911
Devyn Marble,203906,2014-15,208,16,17,5,3,2,8,9,6,3,6,434,12.44813278,115,25,2,0.209150327
Tobias Harris,202699,2014-15,2369,68,124,32,21,11,54,115,28,59,56,4608,22.51157407,2442,244,17,0.400811358
Luke Ridnour,2557,2014-15,683,47,96,28,22,6,32,38,18,10,28,1342,15.01683502,1128,185,17,0.48092356
Maurice Harkless,203090,2014-15,674,45,25,5,3,2,15,27,11,11,16,1314,13.50632069,511,52,1,0.44804839
Willie Green,2584,2014-15,951,52,68,25,23,2,19,48,26,14,34,1840,17.83470275,897,141,6,0.383069999
Andrew Nicholson,203094,2014-15,492,40,22,8,6,2,5,24,9,12,12,939,21.44899905,584,46,1,0.090909091
Isaiah Canaan,203477,2014-15,912,46,98,44,28,16,35,62,23,31,31,1871,21.58139535,1661,239,19,0.712073076
Glenn Robinson III,203922,2014-15,261,35,11,6,4,2,4,11,2,6,5,524,14.77832512,199,35,2,0.424242424
Nerlens Noel,203457,2014-15,2311,75,128,47,40,7,55,146,40,68,78,4558,17.42146849,2662,283,9,0.51422833
Ish Smith,202397,2014-15,831,55,180,65,47,18,84,78,29,27,51,1668,24.2768595,1545,376,10,0.97232833
Tony Wroten,203100,2014-15,895,30,157,54,41,13,72,113,40,53,60,1777,30.61523438,1642,312,8,0.830838819
JaKarr Sampson,203960,2014-15,1131,74,77,25,19,6,30,76,21,35,41,2268,17.92997307,1175,184,11,0.520411451
Luc Mbah a Moute,201601,2014-15,1916,67,106,45,35,10,40,99,27,53,46,3745,18.92965646,2762,285,11,0.565604792
Furkan Aldemir,203128,2014-15,540,41,28,13,13,0,9,17,4,8,9,1057,8.503937008,726,60,4,0.469666103
Joel Embiid,203954,2014-15,0,0,0,0,0,0,0,0,0,0,0,0,0,0,0,0,0
Jason Richardson,2202,2014-15,416,19,38,14,10,4,16,16,9,3,13,812,21.80451128,398,76,3,0.185307018
Hollis Thompson,203138,2014-15,1776,71,85,26,18,8,28,66,26,31,35,3546,15.88162762,1571,215,15,0.383107172
Robert Covington,203496,2014-15,1956,70,105,34,24,10,43,128,35,59,69,3866,21.773113,2088,233,17,0.451023193
Henry Sims,203156,2014-15,1399,73,79,20,16,4,43,99,34,48,51,2765,20.59467919,2245,180,5,0.501259354
Jerami Grant,203924,2014-15,1377,65,79,29,22,7,34,85,29,38,47,2750,16.70357482,1758,216,10,0.559550935
Thomas Robinson,203080,2014-15,798,54,33,12,10,2,14,59,10,37,22,1604,19.56289979,1074,67,6,0.476595182
Eric Bledsoe,202339,2014-15,2800,81,493,157,107,50,194,274,96,123,151,5609,23.78386943,4649,1021,39,0.779195895
Brandon Knight,202688,2014-15,2000,62,330,68,38,30,135,189,85,71,118,4064,25.49402823,3240,671,38,0.616304072
Jerel McNeal,202077,2014-15,36,6,2,0,0,0,0,5,3,0,5,73,21.25,68,7,1,-0.666666667
Markieff Morris,202693,2014-15,2581,82,192,63,33,30,90,170,65,84,86,5171,23.51629503,2860,408,12,0.595649823
TJ Warren,203933,2014-15,614,40,25,10,8,2,8,27,7,16,11,1227,17.66809728,461,67,2,0.505320944
Gerald Green,101123,2014-15,1446,74,91,35,19,16,37,104,26,53,51,2907,28.29268293,1126,187,8,0.589810788
Marcus Morris,202694,2014-15,2045,81,133,39,14,25,51,73,34,26,47,4097,19.18755402,2206,255,14,0.369034735
PJ Tucker,200782,2014-15,2383,78,122,36,26,10,52,96,29,58,38,4747,14.0289103,2473,288,16,0.493347505
Archie Goodwin,203462,2014-15,535,41,44,9,6,3,23,48,20,17,31,1057,23.13311688,749,103,6,0.50870167
Alex Len,203458,2014-15,1518,69,32,13,10,3,14,74,22,38,36,3070,13.56812933,1626,90,3,0.462893596
Danny Granger,101122,2014-15,590,29,17,8,4,4,3,24,4,11,13,1128,16.07000796,467,63,1,0.374853236
Marcus Thornton,201977,2014-15,721,48,36,5,4,1,17,27,11,8,19,1431,23.54003612,593,100,6,0.350540196
Reggie Bullock,203493,2014-15,338,36,8,6,5,1,2,8,5,2,6,653,11.42061281,265,20,3,0.416666667
Earl Barron,2853,2014-15,143,16,5,2,1,1,1,5,1,3,2,278,15.67398119,149,16,0,0.133333333
Brandan Wright,201148,2014-15,1449,75,41,16,14,2,11,34,6,14,20,2838,13.84998444,1278,103,6,0.280803006
Damian Lillard,203081,2014-15,2925,82,507,162,117,45,171,222,110,74,148,5739,26.59866017,5092,1083,65,0.684192156
Dorell Wright,2748,2014-15,593,48,41,16,8,8,11,18,11,4,14,1175,17.01966717,649,82,5,0.330572153
Wesley Matthews,202083,2014-15,2024,60,139,54,40,14,32,81,32,32,49,3982,19.7353914,1948,290,23,0.375876881
CJ McCollum,203468,2014-15,973,62,64,24,10,14,20,48,25,12,36,1922,20.45244691,931,136,11,0.390020046
Arron Afflalo,201167,2014-15,2502,78,129,45,30,15,53,116,29,60,56,4919,19.03754627,1795,319,37,0.570650928
Steve Blake,2581,2014-15,1529,81,288,86,54,32,112,104,59,32,72,2990,13.28982498,2709,613,38,0.750595828
Tim Frazier,204025,2014-15,240,11,60,27,18,9,17,25,9,10,15,484,17.33576642,491,126,5,0.2
Meyers Leonard,203086,2014-15,847,55,32,16,11,5,7,39,4,31,8,1662,16.05206074,906,80,2,0.499791823
LaMarcus Aldridge,200746,2014-15,2512,71,124,60,45,15,40,122,26,54,68,4918,30.10657194,2699,317,31,0.530971105
Joel Freeland,200777,2014-15,617,48,16,11,7,4,2,23,6,8,15,1201,13.50954479,532,44,1,0.415794933
Allen Crabbe,203459,2014-15,683,51,39,15,12,3,8,15,5,9,6,1356,11.48293963,614,77,2,0.36122201
Alonzo Gee,202087,2014-15,661,54,25,10,9,1,6,33,10,16,17,1339,16.76567657,483,64,6,0.364277666
Chris Kaman,2549,2014-15,1398,74,65,34,22,12,15,108,26,40,68,2693,22.89826627,1500,154,10,0.423460312
Robin Lopez,201577,2014-15,1638,59,55,24,20,4,10,73,11,42,31,3160,15.67702553,1030,131,7,0.350456019
Nicolas Batum,201587,2014-15,2380,71,341,90,62,28,134,132,77,45,87,4676,14.54000375,3456,637,45,0.555825381
Ray McCallum,203492,2014-15,1436,68,188,34,19,15,90,85,31,38,47,2863,17.91629027,2534,444,37,0.626336658
Ryan Hollins,200797,2014-15,441,46,14,1,1,0,6,25,5,13,12,870,13.50253807,366,28,0,0.006666667
Darren Collison,201954,2014-15,1565,45,252,41,31,10,102,112,43,40,72,3135,21.03477523,2904,498,21,0.509539736
Rudy Gay,200752,2014-15,2408,68,250,62,30,32,116,183,58,76,107,4788,26.82882224,2530,474,18,0.567962481
David Stockton,204065,2014-15,33,3,9,4,4,0,3,4,2,0,4,72,15.18987342,64,21,1,0.111111111
Nik Stauskas,203917,2014-15,1127,73,67,10,6,4,28,40,16,13,27,2233,14.20233463,875,128,2,0.268692425
Derrick Williams,202682,2014-15,1462,74,50,14,9,5,22,56,20,29,27,2920,18.94578313,1258,111,4,0.390111068
DeMarcus Cousins,202326,2014-15,2013,59,210,89,59,30,85,254,73,124,130,4015,34.02489627,2437,423,11,0.708342615
Omri Casspi,201956,2014-15,1416,67,102,21,11,10,52,88,26,37,51,2821,18.73638344,1609,217,10,0.477286087
Andre Miller,1889,2014-15,1253,81,284,59,44,15,126,104,57,32,72,2358,15.75868373,2572,576,14,0.770952848
Ben McLemore,203463,2014-15,2670,82,140,22,11,11,72,138,46,58,80,5306,17.25170521,2149,249,21,0.353984796
Carl Landry,201171,2014-15,1192,70,26,6,6,0,9,54,4,35,19,2331,18.40238895,1116,62,4,0.233874771
Eric Moreland,203961,2014-15,2,3,0,0,0,0,0,0,0,0,0,5,20,3,0,0,0
Reggie Evans,2501,2014-15,764,47,32,7,5,2,15,45,11,23,22,1455,13.20645905,801,80,5,0.395790902
Jason Thompson,201574,2014-15,1991,81,85,17,13,4,45,84,21,43,41,3903,13.11327154,2113,167,3,0.396292015
Kyle Anderson,203937,2014-15,358,33,28,7,2,5,11,10,5,4,6,702,13.26530612,499,69,3,0.10952381
Kawhi Leonard,202695,2014-15,2033,64,161,47,28,19,67,97,33,41,56,3972,23.09587814,2055,328,32,0.503249968
Marco Belinelli,201158,2014-15,1388,62,94,38,23,15,34,61,25,23,38,2702,18.97350993,1491,172,29,0.464251968
Cory Joseph,202709,2014-15,1444,79,188,72,58,14,51,67,20,27,40,2809,16.9924338,2613,377,37,0.52727595
Patty Mills,201988,2014-15,801,51,87,33,22,11,30,35,12,13,22,1598,21.30697419,1411,169,22,0.512040266
Tony Parker,2225,2014-15,1953,68,335,118,72,46,117,146,51,59,87,3793,24.74616293,3690,677,68,0.699644087
Jeff Ayres,201965,2014-15,383,51,14,3,2,1,8,26,9,13,13,759,15.66820276,479,31,4,0.285714286
Danny Green,201980,2014-15,2312,81,158,36,22,14,69,93,38,42,51,4500,17.35340729,2843,296,37,0.380570983
Matt Bonner,2588,2014-15,935,72,47,16,14,2,12,11,3,4,7,1834,12.51217137,1196,82,2,0.206552543
Aron Baynes,203382,2014-15,1122,70,35,14,12,2,12,65,15,31,34,2205,17.63285024,1006,87,7,0.399186055
Manu Ginobili,1938,2014-15,1587,70,293,89,58,31,140,154,79,48,106,3145,23.58757062,2269,557,50,0.81525868
Tim Duncan,1495,2014-15,2227,77,230,53,34,19,110,131,44,55,76,4342,22.42336968,3269,395,14,0.480178811
Tiago Splitter,201168,2014-15,1030,52,78,22,11,11,38,60,23,25,35,2007,18.41059603,1328,154,13,0.50693141
Boris Diaw,2564,2014-15,1984,81,233,72,42,30,85,126,43,58,68,3850,18.38895282,3429,467,25,0.532166603
Reggie Williams,202130,2014-15,0,0,0,0,0,0,0,0,0,0,0,0,0,0,0,0,0
Landry Fields,202361,2014-15,216,26,15,5,3,2,5,8,3,3,5,427,10.8559499,187,31,1,0.125
James Johnson,201949,2014-15,1370,70,95,35,15,20,41,79,18,41,38,2629,17.42876077,1115,191,9,0.617045621
Bruno Caboclo,203998,2014-15,23,8,0,0,0,0,0,4,1,1,3,45,29.09090909,18,1,0,0
Kyle Lowry,200768,2014-15,2414,70,473,134,87,47,200,173,67,69,104,4728,24.95849474,3969,872,33,0.753341265
DeMar DeRozan,201942,2014-15,2100,60,210,103,67,36,70,137,39,49,88,4056,28.59939104,1959,490,41,0.759825218
Amir Johnson,101161,2014-15,1979,75,117,25,18,7,51,110,25,65,45,3820,15.75813101,2504,227,9,0.385235028
Jonas Valanciunas,202685,2014-15,2096,80,39,17,11,6,16,109,14,61,48,4031,19.47540984,2001,79,5,0.443202622
Greivis Vasquez,202349,2014-15,1991,82,302,81,52,29,127,119,59,46,73,3815,20.05070293,3555,556,54,0.586582688
Lou Williams,101150,2014-15,2016,80,164,62,35,27,56,101,52,24,77,3937,26.42936596,1930,351,33,0.488025877
Terrence Ross,203082,2014-15,2092,82,86,28,18,10,32,69,20,24,45,4012,18.43368237,1210,160,9,0.355663021
Greg Stiemsma,201880,2014-15,66,17,3,2,2,0,1,7,2,4,3,132,11.40939597,70,6,0,0.523809524
Chuck Hayes,101236,2014-15,255,29,20,7,6,1,7,8,3,2,6,490,10.70780399,236,29,1,0.116666667
Tyler Hansbrough,201946,2014-15,1058,74,21,11,7,4,2,20,1,14,6,1999,10.90670171,792,48,6,0.291688966
Patrick Patterson,202335,2014-15,2156,81,155,58,35,23,67,54,21,28,26,4169,13.02354657,2975,261,12,0.521413059
Lucas Nogueira,203512,2014-15,23,6,1,0,0,0,1,2,0,2,0,50,19.04761905,37,2,0,0.666666667
Joe Ingles,204060,2014-15,1673,79,182,51,23,28,102,98,48,34,64,3136,12.96654686,2245,396,22,0.702731453
Trey Burke,203504,2014-15,2288,76,328,83,57,26,156,124,66,36,88,4309,23.83616384,4503,728,45,0.638617879
Rodney Hood,203918,2014-15,1064,50,83,28,20,8,37,45,16,21,24,1979,19.73856209,1211,187,12,0.602191135
Bryce Cotton,203955,2014-15,159,15,15,2,1,1,10,12,7,4,8,331,23.35958005,288,44,4,0.244444444
Alec Burks,202692,2014-15,899,27,82,24,18,6,38,52,27,18,34,1693,20.95531587,1289,187,11,0.557898109
Dante Exum,203957,2014-15,1817,82,198,63,42,21,104,118,72,31,87,3342,14.09827631,2987,424,22,0.63963842
Elijah Millsap,202407,2014-15,924,47,58,21,14,7,27,67,21,31,36,1725,17.08766716,927,136,8,0.60904436
Derrick Favors,202324,2014-15,2280,74,112,49,33,16,35,121,37,54,67,4251,24.26470588,3631,273,13,0.427016405
Grant Jerrett,203511,2014-15,51,8,3,1,1,0,1,3,2,0,3,107,23.7704918,73,6,0,0
Gordon Hayward,202330,2014-15,2618,76,313,117,74,43,133,206,75,87,119,4945,26.17883339,3605,738,52,0.759442326
Chris Johnson,203187,2014-15,0,0,0,0,0,0,0,0,0,0,0,0,0,0,0,0,0
Rudy Gobert,203497,2014-15,2158,82,109,44,33,11,38,111,26,64,47,4030,14.15456874,3293,253,9,0.471886926
Trevor Booker,202344,2014-15,1564,79,83,38,28,10,31,88,25,42,46,2908,18.30778302,2794,228,10,0.551133031
Jeremy Evans,202379,2014-15,266,38,13,8,8,0,3,5,1,3,2,499,12.95336788,361,33,4,0.379487179
Jack Cooley,204022,2014-15,87,16,1,0,0,0,0,3,0,3,0,182,16.35514019,100,4,0,-0.333333333
Will Bynum,101198,2014-15,67,7,18,4,4,0,5,8,6,1,7,131,26.79738562,120,32,2,-0.125
John Wall,202322,2014-15,2837,79,792,208,136,72,339,304,145,101,203,5621,25.73506165,5668,1561,82,0.960370415
Bradley Beal,203078,2014-15,2107,63,194,40,27,13,74,123,49,51,72,4100,22.60586319,2326,394,34,0.41555882
Marcin Gortat,101162,2014-15,2453,82,97,36,22,14,23,100,22,57,43,4828,17.56259205,2919,204,16,0.284631177
Ramon Sessions,201196,2014-15,1188,64,182,44,33,11,80,86,35,34,52,2276,19.19075145,2198,414,19,0.683272857
Rasual Butler,2446,2014-15,1505,75,63,6,4,2,25,48,16,20,28,2908,17.78644271,1177,123,6,0.150516263
Martell Webster,101110,2014-15,352,32,17,0,0,0,7,22,11,3,19,696,18.04320203,296,39,1,-0.209447415
Kevin Seraphin,202338,2014-15,1235,79,59,12,10,2,24,98,12,62,36,2301,22.13363705,1407,144,4,0.373331785
Garrett Temple,202066,2014-15,736,52,56,9,8,1,20,34,16,14,20,1447,13.87530562,726,107,13,0.281208733
Otto Porter Jr.,203490,2014-15,1432,74,65,12,8,4,27,52,14,32,20,2730,15.21808341,1064,141,7,0.369444023
Paul Pierce,1718,2014-15,1914,73,144,21,18,3,72,92,34,42,50,3795,19.85398022,1520,262,13,0.440595103
Nene ,2403,2014-15,1694,67,123,26,17,9,56,124,30,71,53,3302,21.97891322,1794,243,14,0.469759182
Kris Humphries,2743,2014-15,1345,64,57,16,11,5,16,46,18,22,24,2568,18.50969718,1842,123,5,0.21238219
DeJuan Blair,201971,2014-15,180,29,3,1,1,0,1,13,4,6,7,362,17.7184466,221,13,0,0.153846154
Drew Gooden,2400,2014-15,864,51,49,7,5,2,24,28,13,11,17,1654,17.1957672,1096,88,6,0.279082598
Jeff Teague,201952,2013-14,2515,78,528,169,124,45,180,232,97,80,152,5062,25.42882405,4398,1087,60,0.788625269
Lou Williams,101150,2013-14,1420,59,210,53,39,14,79,92,40,36,56,2842,21.08280255,1837,366,19,0.549323911
Paul Millsap,200794,2013-14,2453,73,232,85,44,41,90,185,46,96,89,4905,25.56787207,3233,477,33,0.602613403
DeMarre Carroll,201960,2013-14,2341,73,134,52,30,22,49,79,27,34,45,4570,15.24795002,2510,269,23,0.452604066
Pero Antic,203544,2013-14,902,49,58,20,16,4,21,55,13,32,23,1838,18.32208293,1167,117,7,0.4641381
Shelvin Mack,202714,2013-14,1468,72,271,96,67,29,91,89,39,32,57,2907,19.20345786,2610,548,38,0.72647911
John Jenkins,203098,2013-14,158,13,11,5,4,1,2,11,4,4,7,310,16.07142857,154,18,1,0.090909091
Gustavo Ayon,202970,2013-14,421,25,28,9,7,2,12,29,6,17,12,835,14.96815287,682,55,1,0.278735632
Al Horford,201143,2013-14,958,29,76,29,19,10,29,64,14,42,22,1900,24.88129155,1262,177,10,0.64025471
Dennis Schroder,203471,2013-14,622,48,93,24,15,9,36,61,30,26,35,1230,19.66250917,1149,198,14,0.61122286
Cartier Martin,201858,2013-14,870,59,33,13,7,6,9,34,11,17,17,1695,17.27609963,740,76,5,0.356725691
Kyle Korver,2594,2013-14,2380,70,208,51,34,17,82,102,51,29,73,4787,13.7607799,2375,372,18,0.380461752
Mike Muscala,203488,2013-14,215,20,7,2,0,2,2,12,1,6,6,422,19.44444444,315,15,4,0.071428571
Mike Scott,203118,2013-14,1454,79,75,30,19,11,24,79,21,36,43,2905,23.86008745,1614,152,11,0.40394723
Elton Brand,1882,2013-14,1392,72,74,30,21,9,21,60,15,28,32,2753,14.28101349,1857,161,9,0.380437974
Avery Bradley,202340,2013-14,1855,60,85,18,17,1,39,96,33,46,50,3629,23.40168878,1733,213,20,0.40137684
Keith Bogans,2586,2013-14,55,6,3,1,1,0,0,1,0,1,0,107,5.511811024,54,4,0,0
Jared Sullinger,203096,2013-14,2041,74,118,39,25,14,40,119,23,69,50,3992,23.8362069,2347,279,13,0.451675027
Jeff Green,201145,2013-14,2805,82,138,42,26,16,44,165,33,97,68,5490,23.5238396,2538,316,17,0.389644793
Rajon Rondo,200765,2013-14,998,30,294,80,59,21,99,99,41,38,61,1954,20.97411145,2163,644,28,1.013148208
Jerryd Bayless,201573,2013-14,1686,72,194,56,43,13,57,82,39,30,52,3202,19.73509934,2301,440,34,0.489952704
Chris Johnson,203187,2013-14,0,0,0,0,0,0,0,0,0,0,0,0,0,0,0,0,0
Phil Pressey,203515,2013-14,1132,75,241,55,45,10,114,87,44,28,59,2184,14.4338118,2158,476,29,0.782927146
Brandon Bass,101138,2013-14,2266,82,87,27,14,13,26,102,22,51,51,4380,18.69121473,2129,207,8,0.297774545
Vitor Faverani,203543,2013-14,488,37,16,4,1,3,9,41,8,20,21,935,19.36090226,705,39,2,0.308434959
Kelly Olynyk,203482,2013-14,1400,70,109,31,19,12,50,106,19,65,41,2770,20.64777328,1886,196,10,0.524778763
Kris Humphries,2743,2013-14,1376,69,67,24,16,8,20,64,21,35,29,2634,19.31484502,1959,183,9,0.398750612
Gerald Wallace,2222,2013-14,1416,58,143,44,19,25,54,97,40,40,57,2736,11.79438663,1724,257,10,0.486674164
Joel Anthony,201202,2013-14,186,33,2,2,2,0,0,3,0,3,0,364,9.466019417,142,12,0,0.666666667
Chris Babb,203569,2013-14,132,14,3,0,0,0,1,3,2,1,2,260,11.0367893,112,7,2,-0.222222222
Andray Blatche,101154,2013-14,1591,72,112,55,37,18,40,110,20,62,48,3099,25.35940196,1891,229,5,0.634460986
Mason Plumlee,203486,2013-14,1272,69,60,21,18,3,20,77,20,32,45,2434,17.15650257,1215,118,5,0.345081442
Kevin Garnett,708,2013-14,1090,53,82,27,21,6,34,68,24,36,32,2072,19.45780498,1801,160,7,0.489334885
Alan Anderson,101187,2013-14,1745,77,81,29,14,15,28,62,25,28,34,3350,15.92424647,1397,174,9,0.411840751
Joe Johnson,2207,2013-14,2544,78,216,83,62,21,77,120,42,53,67,4875,22.46136865,2307,448,38,0.591588516
Deron Williams,101114,2013-14,2059,64,392,146,111,35,130,143,57,52,91,3941,21.81524994,3885,817,54,0.765717658
Marcus Thornton,201977,2013-14,1711,71,77,19,11,8,39,67,32,18,49,3349,19.67170401,1183,156,10,0.399175209
Brook Lopez,201572,2013-14,533,17,16,9,5,4,4,28,4,16,12,1018,26.92982456,361,42,3,0.531452264
Marquis Teague,203104,2013-14,442,40,58,24,17,7,18,39,11,22,17,839,17.99379524,749,134,10,0.245505452
Jorge Gutierrez,203268,2013-14,244,15,30,10,6,4,11,14,4,8,6,469,14.14913958,363,64,5,0.223809524
Shaun Livingston,2733,2013-14,1952,75,245,89,64,25,101,105,31,55,50,3704,16.38472692,3223,524,33,0.714470781
Mirza Teletovic,203141,2013-14,1373,71,57,20,8,12,25,54,16,25,29,2687,20.19262703,1604,125,8,0.446099695
Paul Pierce,1718,2013-14,2071,74,178,65,39,26,60,153,51,74,79,3994,22.54635911,2399,391,20,0.548582827
Andrei Kirilenko,1905,2013-14,836,44,72,12,10,2,44,54,23,26,28,1625,14.52574526,820,129,6,0.583228232
Jason Collins,2215,2013-14,172,22,4,1,1,0,2,7,1,5,2,343,8.823529412,148,9,0,0.321428571
Bismack Biyombo,202687,2013-14,1061,76,8,2,1,1,2,40,2,27,13,2027,9.630266552,479,38,3,0.173480543
Jannero Pargo,2457,2013-14,242,29,52,23,17,6,18,26,11,10,16,470,27.97731569,467,109,5,0.25
DJ White,201591,2013-14,10,2,0,0,0,0,0,0,0,0,0,22,3.703703704,15,0,0,0
Gerald Henderson,201945,2013-14,0,0,0,0,0,0,0,0,0,0,0,0,0,0,0,0,0
Josh McRoberts,201177,2013-14,2329,77,333,63,41,22,140,83,29,40,43,4448,13.85979049,5154,615,31,0.486972139
Gary Neal,202390,2013-14,1088,51,83,22,16,6,33,64,23,30,34,2132,24.10491257,1160,187,13,0.485315832
Luke Ridnour,2557,2013-14,1129,60,176,46,38,8,73,66,39,20,46,2157,16.5779779,1994,364,26,0.615436653
Michael Kidd-Gilchrist,203077,2013-14,1472,61,52,11,10,1,19,60,13,35,25,2809,15.5632256,999,137,9,0.334908644
Kemba Walker,202689,2013-14,2577,72,447,104,81,23,153,169,65,55,114,4999,25.8983891,5414,907,59,0.53624694
Al Jefferson,2744,2013-14,2517,72,155,50,40,10,66,124,20,61,63,4893,29.73370064,1910,338,29,0.556949125
Brendan Haywood,2217,2013-14,0,0,0,0,0,0,0,0,0,0,0,0,0,0,0,0,0
Cody Zeller,203469,2013-14,1400,81,92,24,12,12,35,87,30,44,43,2774,18.35642317,2588,196,10,0.358954214
Anthony Tolliver,201229,2013-14,1281,63,42,16,11,5,13,23,10,12,11,2535,12.12653779,1148,99,9,0.361242873
Jeffery Taylor,203106,2013-14,629,26,22,5,3,2,9,25,8,10,15,1226,18.83439943,484,56,5,0.307762989
Chris Douglas-Roberts,201604,2013-14,994,48,51,16,13,3,13,36,6,19,17,1955,14.68978102,699,98,8,0.316678546
Derrick Rose,201565,2013-14,311,10,43,9,6,3,20,34,9,12,22,605,29.4036061,608,110,6,0.125398997
Carlos Boozer,2430,2013-14,2141,76,118,36,30,6,49,154,39,79,75,4077,26.08881298,2320,271,9,0.468054698
Mike James,2229,2013-14,77,11,17,2,2,0,7,5,3,1,4,133,17.41935484,142,32,2,-0.070588235
Greg Smith,202962,2013-14,0,0,0,0,0,0,0,0,0,0,0,0,0,0,0,0,0
Ronnie Brewer,200758,2013-14,160,24,10,6,3,3,2,2,2,0,2,322,5.217391304,134,16,1,0.133333333
Kirk Hinrich,2550,2013-14,2116,73,286,70,48,22,84,120,56,44,76,3967,17.42076503,3953,682,66,0.488850527
Joakim Noah,201149,2013-14,2820,80,431,92,71,21,192,194,70,92,102,5263,18.7971157,5318,867,20,0.620819673
D.J. Augustin,201571,2013-14,1925,70,313,73,48,25,112,125,55,48,77,3605,22.5681873,3776,736,70,0.629640563
Lou Amundson,200811,2013-14,185,19,6,4,3,1,1,14,2,10,4,344,14.25061425,234,26,2,0.404761905
Tony Snell,203503,2013-14,1231,77,68,10,9,1,24,44,17,17,27,2291,15.09290861,938,158,4,0.258915643
Jimmy Butler,202710,2013-14,2591,67,175,44,28,16,65,102,36,47,55,4826,17.0613563,2347,374,35,0.413483425
Taj Gibson,201959,2013-14,2351,82,91,39,29,10,33,150,28,91,59,4344,23.35257814,2300,225,10,0.520294389
Jimmer Fredette,202690,2013-14,519,49,64,12,7,5,29,48,16,16,32,1009,24.3567753,755,139,8,0.536998141
Mike Dunleavy,2399,2013-14,2584,82,186,31,18,13,78,108,58,38,70,4854,16.91977845,2513,383,29,0.337266085
Nazr Mohammed,1737,2013-14,562,80,20,6,5,1,7,37,9,20,17,1020,14.83979764,506,42,1,0.321250562
CJ Miles,101139,2013-14,984,51,52,17,11,6,16,44,17,20,24,1910,21.80755396,740,112,3,0.384636359
Jarrett Jack,101127,2013-14,2252,80,324,102,70,32,102,133,49,56,77,4319,18.01692866,3476,724,41,0.633091233
Kyrie Irving,202681,2013-14,2496,71,433,99,72,27,141,190,67,81,109,4830,27.85918513,3981,811,37,0.558348644
Dion Waiters,203079,2013-14,2072,70,209,68,40,28,67,154,47,73,81,4004,26.91645134,1977,414,28,0.54649015
Matthew Dellavedova,203521,2013-14,1271,72,187,48,35,13,78,60,32,19,41,2451,13.20754717,1775,378,17,0.623047046
Luol Deng,2736,2013-14,2213,63,183,44,23,21,72,114,41,50,64,4219,22.34933606,2081,368,18,0.456540108
Sergey Karasev,203508,2013-14,156,22,6,0,0,0,3,11,8,3,8,316,14.52991453,149,18,1,-0.075757576
Tristan Thompson,202684,2013-14,2594,82,72,26,16,10,24,108,20,66,42,4967,17.73356401,3044,165,14,0.349294802
Anthony Bennett,203461,2013-14,663,52,17,3,3,0,7,47,9,31,16,1310,19.97380485,824,42,1,0.255746074
Anderson Varejao,2760,2013-14,1800,65,140,44,31,13,56,72,23,28,44,3418,14.80370093,2678,294,10,0.450365431
Scotty Hopson,203816,2013-14,7,2,1,0,0,0,1,0,0,0,0,15,29.41176471,8,1,0,0
Carrick Felix,203467,2013-14,38,7,4,0,0,0,2,4,1,1,3,82,21.73913043,36,7,0,-0.083333333
Spencer Hawes,201150,2013-14,2470,80,240,42,30,12,130,173,74,72,101,5029,19.67069539,4049,486,14,0.505519094
Alonzo Gee,202087,2013-14,1020,65,47,13,9,4,10,44,17,18,26,1983,13.51114998,973,113,6,0.185978648
Tyler Zeller,203092,2013-14,1049,70,36,12,10,2,10,60,5,41,19,2016,17.33905579,943,64,6,0.301101213
Tyson Chandler,2199,2013-14,1662,55,59,22,21,1,9,71,16,44,27,3103,12.99323563,1572,142,6,0.241099851
Raymond Felton,101109,2013-14,2017,65,365,143,114,29,133,129,59,40,89,3801,18.36876155,3710,734,38,0.754607348
Shawn Marion,1890,2013-14,2409,76,124,52,37,15,36,95,44,34,61,4682,15.87664192,2756,282,24,0.381692226
Bernard James,203108,2013-14,146,30,3,2,2,0,0,10,0,5,5,301,10.77844311,90,9,2,0.166666667
Ricky Ledo,203495,2013-14,33,11,2,1,1,0,0,2,1,1,1,68,28,31,3,0,2.78E-17
Jae Crowder,203109,2013-14,1254,78,60,20,16,4,23,41,13,20,21,2441,13.29437546,1401,130,9,0.409060751
Monta Ellis,101145,2013-14,3023,82,471,163,130,33,184,264,102,100,164,5929,26.14064147,3889,956,79,0.758390012
Devin Harris,2734,2013-14,818,40,178,62,47,15,66,59,25,22,37,1590,20.18962632,1557,335,17,0.801421048
Vince Carter,1713,2013-14,1973,81,212,52,37,15,104,108,45,52,56,3889,22.99794661,2371,406,25,0.606689986
Gal Mekel,203539,2013-14,292,31,63,25,22,3,21,31,13,15,16,593,18.14159292,578,120,10,0.224782386
Brandan Wright,201148,2013-14,1077,58,31,16,15,1,6,35,4,16,19,2072,17.74817361,810,90,3,0.390068276
Dirk Nowitzki,1717,2013-14,2628,80,216,58,34,24,105,117,42,35,82,5141,26.76031911,3319,446,33,0.491766694
DeJuan Blair,201971,2013-14,1214,78,70,28,22,6,24,77,22,39,38,2410,19.16299559,1051,134,5,0.482898179
Aaron Brooks,201166,2013-14,1557,72,233,80,43,37,101,117,54,38,79,3169,20.48092869,2022,461,28,0.742493772
Darrell Arthur,201589,2013-14,1161,68,61,17,9,8,27,58,20,31,27,2346,18.64661654,1165,126,8,0.449487367
Ty Lawson,201951,2013-14,2222,62,543,170,121,49,244,200,103,65,135,4580,22.69692924,3651,1188,47,1.064141375
Randy Foye,200751,2013-14,2485,81,287,74,43,31,153,145,71,54,91,5113,18.51099831,2293,601,26,0.752365187
JJ Hickson,201581,2013-14,1859,69,96,40,26,14,42,128,16,85,43,3775,20.87811571,2113,234,17,0.645471312
Danilo Gallinari,201568,2013-14,0,0,0,0,0,0,0,0,0,0,0,0,0,0,0,0,0
Nate Robinson,101126,2013-14,866,44,112,22,17,5,40,58,26,22,36,1701,24.37275986,1073,245,13,0.524583254
Anthony Randolph,201576,2013-14,527,43,32,17,14,3,10,39,12,25,14,1080,20.19785655,553,81,1,0.690932516
Wilson Chandler,201163,2013-14,1927,62,114,38,34,4,47,79,27,40,39,3941,19.57098629,1756,227,15,0.494794499
Jan Vesely,202686,2013-14,776,54,21,5,3,2,12,36,6,25,11,1509,13.37507114,918,57,4,0.509883736
Timofey Mozgov,202389,2013-14,1770,82,62,26,18,8,21,122,18,79,43,3595,19.04531136,1955,139,7,0.456875662
Quincy Miller,203113,2013-14,789,52,26,10,8,2,9,48,14,17,31,1629,17.39820201,528,68,6,0.397131043
JaVale McGee,201580,2013-14,79,5,2,0,0,0,2,8,2,4,4,162,24.7311828,68,5,0,0.5
Kenneth Faried,202702,2013-14,2178,80,96,42,24,18,46,134,49,55,79,4440,21.31147541,2154,200,16,0.571493796
Evan Fournier,203095,2013-14,1504,76,112,30,19,11,44,100,34,44,56,3113,19.49790795,1405,263,22,0.502769919
Andre Drummond,203083,2013-14,2619,81,35,9,7,2,19,110,16,72,38,5112,16.94664032,2069,98,6,0.436299891
Chauncey Billups,1497,2013-14,309,19,42,10,8,2,19,25,7,11,14,603,15.4494382,443,85,6,0.17047619
Rodney Stuckey,201155,2013-14,1950,73,152,34,22,12,78,125,46,49,76,3821,24.46284691,1668,326,7,0.563465238
Kentavious Caldwell-Pope,203484,2013-14,1583,80,55,16,10,6,25,28,9,14,14,3136,13.86861314,1251,104,9,0.39428608
Josh Smith,2746,2013-14,2730,77,252,70,32,38,146,199,76,68,131,5403,24.49364107,2662,516,25,0.687229246
Brandon Jennings,201943,2013-14,2728,80,609,104,64,40,344,215,106,60,155,5430,23.17549617,4821,1226,66,0.865706349
Tony Mitchell,203502,2013-14,0,0,0,0,0,0,0,0,0,0,0,0,0,0,0,0,0
Greg Monroe,202328,2013-14,2690,82,171,46,31,15,91,166,41,71,95,5310,21.39216311,2754,401,16,0.571750228
Will Bynum,101198,2013-14,1054,56,216,47,23,24,115,103,42,36,67,2089,23.81729201,1537,455,23,0.927558222
Gigi Datome,203540,2013-14,238,34,11,4,2,2,6,11,2,7,4,475,20.10676157,223,24,4,0.454545455
Kyle Singler,202713,2013-14,2337,82,75,22,18,4,35,79,14,46,33,4614,14.05674282,2021,155,14,0.430445213
Charlie Villanueva,101111,2013-14,180,20,6,3,1,2,3,7,2,3,4,349,25.36231884,227,13,1,0.476190476
Jonas Jerebko,201973,2013-14,741,64,39,11,7,4,19,43,16,18,25,1443,16.13278975,834,67,1,0.412853071
Peyton Siva,203491,2013-14,224,24,34,15,12,3,13,18,7,10,8,411,16.43286573,370,83,7,0.34204793
Josh Harrellson,202725,2013-14,317,32,15,3,2,1,9,10,4,5,5,631,12.87262873,301,30,1,0.3
Ognjen Kuzmic,203136,2013-14,92,21,2,2,1,1,0,10,4,5,5,200,12.38938053,64,7,0,0.5
Marreese Speights,201578,2013-14,971,78,32,12,9,3,12,66,14,34,32,1977,25.11091393,752,80,3,0.443822773
Jermaine O'Neal,979,2013-14,862,43,25,9,5,4,7,52,9,32,20,1724,18.56627127,646,50,6,0.31386556
Nemanja Nedovic,203517,2013-14,134,23,13,6,4,2,1,13,7,2,11,295,16.66666667,178,37,1,-0.076923077
Andre Iguodala,2738,2013-14,2040,63,263,100,64,36,96,100,41,42,58,4061,13.51410453,2051,455,29,0.663462701
David Lee,101135,2013-14,2253,68,147,57,32,25,57,152,39,71,81,4599,24.28598812,2279,281,31,0.512567577
Klay Thompson,202691,2013-14,2827,80,181,46,31,15,85,135,35,70,65,5737,22.74268105,1487,338,20,0.576794413
Andrew Bogut,101106,2013-14,1746,66,112,39,30,9,40,97,30,55,42,3542,12.5,2089,228,12,0.467421236
Draymond Green,203110,2013-14,1775,81,152,54,38,16,67,91,31,53,38,3591,15.00984252,2296,299,18,0.622202344
Steve Blake,2581,2013-14,1498,55,307,90,52,38,111,102,63,32,70,3023,13.96449704,2619,611,38,0.733803944
Stephen Curry,201939,2013-14,2806,77,666,154,102,52,329,294,149,97,197,5747,27.89765721,4123,1173,72,0.871070246
Festus Ezeli,203105,2013-14,0,0,0,0,0,0,0,0,0,0,0,0,0,0,0,0,0
Harrison Barnes,203084,2013-14,2165,77,116,43,30,13,48,84,17,46,38,4420,16.9498301,1491,215,16,0.543861458
Jordan Crawford,202348,2013-14,1860,81,281,86,51,35,100,134,43,60,74,3678,23.61244019,2784,582,29,0.666463723
Hilton Armstrong,200756,2013-14,97,15,5,0,0,0,3,6,0,5,1,195,13.55932203,86,11,0,0.211111111
Isaiah Canaan,203477,2013-14,252,22,22,9,6,3,9,21,6,9,12,534,20.29950083,398,55,7,0.294372294
Patrick Beverley,201976,2013-14,1751,56,151,59,43,16,72,66,26,30,36,3438,14.95823842,2657,317,25,0.652745049
Omer Asik,201600,2013-14,968,48,25,12,11,1,8,59,11,40,19,1974,13.7254902,1131,68,4,0.489693752
Jordan Hamilton,202706,2013-14,1020,60,52,21,14,7,18,46,16,18,28,2058,18.76053963,902,122,7,0.468630948
Terrence Jones,203093,2013-14,2078,76,87,34,27,7,47,71,23,27,44,4119,18.48685617,2142,174,15,0.556095232
Jeremy Lin,202391,2013-14,2054,71,294,102,73,29,150,176,78,62,114,4188,20.2192705,2985,548,27,0.758281517
Dwight Howard,2730,2013-14,2396,71,131,48,38,10,71,229,37,130,99,4755,24.34718647,2860,283,15,0.648023381
James Harden,201935,2013-14,2777,73,446,151,101,50,240,265,104,96,169,5598,27.42642455,3346,909,43,0.92976898
Omri Casspi,201956,2013-14,1283,71,88,34,25,9,40,72,22,33,39,2624,18.02675585,1718,175,10,0.565281898
Donatas Motiejunas,202700,2013-14,952,62,34,25,20,5,6,49,12,25,24,1944,17.59890859,1165,104,8,0.61368015
Josh Powell,2694,2013-14,19,1,0,0,0,0,0,1,0,1,0,37,17.07317073,14,1,0,0
Chandler Parsons,202718,2013-14,2783,74,298,99,68,31,155,144,55,56,88,5574,19.40747782,3074,525,36,0.674744551
Troy Daniels,203584,2013-14,75,5,5,3,1,2,0,3,1,2,1,145,20.1183432,66,8,1,0.155555556
Francisco Garcia,101128,2013-14,1083,55,63,23,13,10,27,30,11,13,17,2193,13.4057971,945,110,7,0.489400402
Robert Covington,203496,2013-14,34,7,0,0,0,0,0,1,0,1,0,68,19.48051948,21,2,0,0
Lance Stephenson,202362,2013-14,2752,78,359,91,54,37,123,210,84,88,122,5258,19.4668008,2983,704,36,0.560934128
George Hill,201588,2013-14,2434,76,265,57,37,20,63,92,39,42,50,4636,14.84567317,4279,564,44,0.30186127
Luis Scola,2449,2013-14,1399,82,81,31,23,8,28,108,29,53,55,2683,23.98560209,2107,185,8,0.445348517
Lavoy Allen,202730,2013-14,1071,65,71,26,24,2,27,43,14,22,21,2199,14.28015564,1654,164,4,0.502636327
Rasual Butler,2446,2013-14,378,50,17,5,3,2,8,11,7,3,8,723,15.51515152,284,32,0,0.188948307
Solomon Hill,203524,2013-14,226,28,12,6,5,1,1,13,4,7,6,423,11.53846154,224,34,2,0.096153846
Evan Turner,202323,2013-14,2457,81,262,72,58,14,128,189,69,67,122,4998,23.25008794,2736,578,37,0.661361442
Donald Sloan,202388,2013-14,392,48,50,17,12,5,8,22,9,7,15,756,17.45283019,624,114,3,-0.060606061
Andrew Bynum,101115,2013-14,516,26,29,6,4,2,13,34,6,25,9,1003,24.07566638,388,46,4,0.441307774
David West,2561,2013-14,2472,80,223,72,50,22,90,133,43,72,61,4747,22.02855553,3733,481,23,0.563671939
Chris Copeland,203142,2013-14,265,41,18,7,3,4,5,14,5,6,8,520,23.45890411,238,33,2,0.142857143
Paul George,202331,2013-14,2898,80,283,64,43,21,92,224,87,97,127,5561,28.11016144,3480,620,34,0.421016889
Ian Mahinmi,101133,2013-14,1248,77,24,10,7,3,10,58,8,44,14,2392,11.48623853,952,75,5,0.558417896
C.J. Watson,201228,2013-14,1193,63,107,32,19,13,18,60,17,36,24,2337,16.34651601,1964,254,17,0.342859589
Roy Hibbert,201579,2013-14,2409,81,91,24,22,2,52,148,19,96,52,4577,19.638392,2055,214,13,0.577684179
Glen Davis,201175,2013-14,1662,68,77,19,13,6,35,76,15,42,34,3205,20.44817927,1756,164,14,0.410912932
Darren Collison,201954,2013-14,2069,80,297,103,62,41,115,132,54,56,76,4061,19.84913793,3333,612,47,0.688167641
Chris Paul,101108,2013-14,2171,62,663,169,107,62,300,145,66,52,93,4388,23.3528108,4523,1251,84,1.013082699
JJ Redick,200755,2013-14,987,35,78,24,13,11,39,42,17,19,23,1983,21.36181575,861,159,16,0.637582506
DeAndre Jordan,201599,2013-14,2870,82,74,18,14,4,35,123,30,76,47,5684,12.50578972,3239,138,28,0.346200975
Hedo Turkoglu,2045,2013-14,392,38,33,8,4,4,14,16,6,7,9,760,15.61032864,621,75,5,0.145833333
Jared Dudley,201162,2013-14,1729,74,104,37,23,14,42,56,23,27,29,3414,13.70217166,1526,199,16,0.499164726
Jamal Crawford,2037,2013-14,2094,69,223,50,26,24,106,135,51,53,82,4194,26.86787674,2119,427,52,0.569175197
Ryan Hollins,200797,2013-14,482,61,8,2,1,1,5,29,5,21,8,950,11.96581197,390,25,0,0.449712644
Matt Barnes,2440,2013-14,1735,63,125,31,19,12,70,85,42,31,54,3498,16.4321608,1805,229,14,0.52176024
Reggie Bullock,203493,2013-14,396,43,12,3,2,1,5,13,5,6,7,795,15.43624161,283,38,5,0.153846154
Blake Griffin,201933,2013-14,2863,80,309,95,50,45,139,224,61,120,104,5704,29.19119926,4233,646,42,0.6474342
Danny Granger,101122,2013-14,848,41,41,15,8,7,14,46,17,18,28,1677,19.91657977,689,114,6,0.470976336
Willie Green,2584,2013-14,869,55,50,25,19,6,8,34,13,16,18,1724,16.68393782,858,126,12,0.442043472
Nick Young,201156,2013-14,1810,64,95,27,20,7,33,95,31,36,59,3680,26.76262503,1421,223,20,0.371364228
Jordan Farmar,200770,2013-14,912,41,199,80,53,27,61,95,51,30,65,1885,22.91271347,1822,429,34,0.852989485
MarShon Brooks,202705,2013-14,317,35,25,8,5,3,11,24,6,11,13,664,23.05593452,285,55,2,0.246111111
Ryan Kelly,203527,2013-14,1312,59,95,47,30,17,28,47,13,24,23,2729,15.83695289,1671,196,9,0.55970506
Kent Bazemore,203145,2013-14,911,67,91,24,17,7,40,79,35,27,52,1907,22.39017478,995,170,16,0.508016482
Xavier Henry,202333,2013-14,908,43,51,13,10,3,23,57,14,26,31,1873,22.81116895,926,131,12,0.47700428
Chris Kaman,2549,2013-14,736,39,58,23,13,10,22,74,19,29,45,1527,26.4516129,1070,130,5,0.537951795
Steve Nash,959,2013-14,313,15,86,28,20,8,27,31,14,12,19,656,18.75862069,640,198,12,0.101900475
Wesley Johnson,202325,2013-14,2240,79,124,35,17,18,57,90,43,35,55,4633,15.11900117,2012,249,13,0.439816616
Kendall Marshall,203088,2013-14,1564,54,477,99,71,28,214,150,87,52,98,3233,16.36720943,3404,846,45,0.894525231
Pau Gasol,2200,2013-14,1884,60,201,83,68,15,65,141,55,30,111,3878,26.4835932,2983,452,20,0.532014112
Jodie Meeks,201975,2013-14,2556,77,138,49,35,14,50,111,45,32,79,5272,18.83538251,2145,317,23,0.418628191
Kobe Bryant,977,2013-14,177,6,38,7,2,5,18,34,24,8,26,357,29.14572864,310,79,8,0.069659443
Jordan Hill,201941,2013-14,1500,72,54,30,25,5,12,75,16,32,43,3008,19.71336648,1772,107,7,0.385050414
Robert Sacre,203135,2013-14,1089,65,51,33,28,5,7,44,8,25,19,2241,15.70850202,1275,130,11,0.528377356
James Johnson,201949,2013-14,956,52,111,20,10,10,51,66,24,26,40,1804,19.77186312,1003,197,10,0.506763818
Courtney Lee,201584,2013-14,1973,79,115,22,15,7,34,73,34,33,40,3669,17.25118483,1900,251,19,0.230297485
Tony Allen,2754,2013-14,1278,55,94,14,8,6,45,90,28,40,50,2388,19.95692749,1010,166,11,0.403387945
Mike Conley,201144,2013-14,2446,73,441,78,49,29,172,150,71,40,110,4573,24.43524096,4808,933,91,0.564606311
Nick Calathes,201979,2013-14,1173,71,207,52,38,14,67,101,45,40,61,2195,17.70124149,2376,417,27,0.571229533
Mike Miller,2034,2013-14,1707,82,130,26,14,12,41,77,36,31,46,3245,14.3350146,1912,285,19,0.298935239
Beno Udrih,2757,2013-14,643,41,116,31,19,12,39,47,21,15,32,1237,17.0212766,1256,255,11,0.642768604
Quincy Pondexter,202347,2013-14,270,15,20,3,2,1,8,15,4,9,6,500,18.32460733,220,43,1,0.083333333
Tayshaun Prince,2419,2013-14,1948,76,119,19,13,6,39,41,16,17,24,3583,13.69294606,2175,260,36,0.211950129
Jamaal Franklin,203479,2013-14,162,21,6,3,2,1,1,11,5,6,5,311,14.12742382,119,17,3,0.181818182
Jon Leuer,202720,2013-14,642,49,20,4,4,0,8,27,11,10,17,1219,21.25360231,812,65,5,0.23808549
Ed Davis,202334,2013-14,956,63,27,5,4,1,12,40,4,29,11,1786,17.6217765,997,88,2,0.384944633
Marc Gasol,201188,2013-14,1970,59,215,48,27,21,104,111,27,59,52,3645,22.39382239,2863,457,28,0.609089723
Kosta Koufos,201585,2013-14,1349,80,39,7,6,1,10,67,12,41,26,2510,19.23990499,1628,105,12,0.115542617
Zach Randolph,2216,2013-14,2705,79,200,48,43,5,88,183,54,88,95,5028,26.26712329,2800,435,30,0.489795224
Toney Douglas,201962,2013-14,675,51,68,23,19,4,25,34,22,11,23,1284,16.55124654,977,152,15,0.52782231
Chris Bosh,2547,2013-14,2531,79,87,32,16,16,36,124,39,49,75,4819,22.75142315,2653,211,30,0.409561822
Dwyane Wade,2548,2013-14,1775,54,252,70,39,31,134,161,63,62,99,3418,27.69726248,2075,494,40,0.78760368
LeBron James,2544,2013-14,2902,77,488,180,90,90,187,269,112,101,168,5549,30.84158416,3823,973,83,0.800335581
Justin Hamilton,203120,2013-14,72,8,0,0,0,0,0,4,1,1,3,137,17.56756757,61,2,0,0
Michael Beasley,201563,2013-14,831,55,42,16,8,8,17,57,14,30,27,1584,25.456621,913,82,4,0.48297631
Rashard Lewis,1740,2013-14,971,60,57,25,16,9,17,35,17,15,20,1810,14.28571429,1117,100,11,0.405544708
Chris Andersen,2365,2013-14,1396,72,19,6,2,4,8,53,7,37,16,2600,13.98553221,1024,74,6,0.428154062
Mario Chalmers,201596,2013-14,2178,73,357,77,39,38,182,162,59,73,89,4194,17.2519084,3863,663,48,0.685065272
Greg Oden,201141,2013-14,212,23,1,1,0,1,0,12,1,8,4,406,15.25054466,137,5,1,0.555555556
James Jones,2592,2013-14,236,20,9,3,2,1,2,4,1,2,2,430,16.34819533,215,19,2,0.055555556
Norris Cole,202708,2013-14,2014,82,248,57,23,34,122,127,62,52,75,3767,15.75030012,3259,542,37,0.627015337
Shane Battier,2203,2013-14,1468,73,63,30,16,14,23,21,9,8,13,2795,9.990205681,1765,152,24,0.491248516
Ray Allen,951,2013-14,1936,73,143,57,25,32,61,84,31,34,50,3636,16.57142857,1641,277,17,0.605306818
Udonis Haslem,2617,2013-14,653,46,13,6,4,2,5,24,7,14,10,1213,14.10447761,572,24,6,0.452643112
O.J. Mayo,201564,2013-14,1314,51,113,22,13,9,54,95,45,35,60,2598,22.96795953,1322,239,12,0.491380776
Ekpe Udoh,202327,2013-14,804,42,31,11,9,2,8,38,10,25,13,1498,11.85055458,878,69,9,0.3299434
Nate Wolters,203489,2013-14,1273,57,187,65,50,15,60,57,32,17,40,2519,16.70668954,2174,393,24,0.590690065
Ersan Ilyasova,101141,2013-14,1455,54,72,24,16,8,24,61,22,32,29,2837,21.28111718,2061,170,8,0.374186107
Larry Sanders,202336,2013-14,563,22,19,0,0,0,9,26,7,14,12,1110,16.53726708,657,60,3,0.18440086
Miroslav Raduljica,203545,2013-14,465,48,23,3,3,0,12,28,1,22,6,894,17.1950048,472,54,4,0.247412008
Carlos Delfino,2568,2013-14,0,0,0,0,0,0,0,0,0,0,0,0,0,0,0,0,0
Brandon Knight,202688,2013-14,2400,72,352,98,73,25,115,188,80,61,127,4595,26.79344756,4287,740,53,0.527551214
Jeff Adrien,202399,2013-14,962,53,38,6,5,1,16,39,7,23,16,1860,16.80440771,1014,86,5,0.283071611
Ramon Sessions,201196,2013-14,2214,83,340,86,68,18,124,148,64,53,95,4283,22.41414347,3605,735,43,0.606211576
Chris Wright,202874,2013-14,126,8,5,0,0,0,3,5,1,3,2,245,16.66666667,83,9,1,0.133333333
Khris Middleton,203114,2013-14,2441,81,169,34,23,11,86,123,42,51,72,4713,19.01447151,2615,370,22,0.474672505
Zaza Pachulia,2585,2013-14,1310,52,136,20,15,5,66,92,23,46,46,2544,17.04584041,1519,270,7,0.51620833
John Henson,203089,2013-14,1832,69,113,37,33,4,47,114,25,64,50,3532,20.51093098,2127,226,15,0.493446052
Giannis Antetokounmpo,203507,2013-14,1880,76,150,37,28,9,67,122,32,65,57,3642,15.16090584,2519,299,16,0.482002744
Othyus Jeffers,201785,2013-14,47,6,1,0,0,0,1,1,0,1,0,86,9.090909091,37,5,0,0.666666667
Alexey Shved,203144,2013-14,664,63,68,17,12,5,21,48,20,16,32,1307,21.20026093,656,165,10,0.50328634
Gorgui Dieng,203476,2013-14,818,60,39,11,8,3,17,54,7,38,16,1650,16.99895068,787,83,5,0.492780732
Robbie Hummel,203133,2013-14,655,53,23,6,4,2,7,10,4,5,5,1315,12.5566343,712,65,3,0.255746167
Ricky Rubio,201937,2013-14,2638,82,704,182,132,50,338,221,140,57,164,5430,16.336,5696,1522,86,1.00209984
Chase Budinger,201978,2013-14,751,41,31,8,7,1,15,24,10,8,16,1477,17.28971963,526,67,6,0.402970735
J.J. Barea,200826,2013-14,1471,79,303,65,46,19,122,125,54,50,75,2894,24.41412044,2770,697,23,0.80928026
Luc Mbah a Moute,201601,2013-14,1003,64,36,10,8,2,19,40,6,23,17,1933,11.53508772,794,82,3,0.515584851
Corey Brewer,201147,2013-14,2609,81,135,40,34,6,74,105,34,43,62,5397,16.2327226,2097,253,29,0.53190628
Nikola Pekovic,201593,2013-14,1663,54,50,21,19,2,15,84,12,54,30,3391,22.66396556,1223,114,9,0.429383269
Shabazz Muhammad,203498,2013-14,290,37,6,3,2,1,3,16,4,6,10,579,22.57597685,179,17,2,0.458333333
Kevin Martin,2755,2013-14,2177,68,121,41,32,9,49,106,35,46,60,4496,24.73243822,1840,277,35,0.499571873
Ronny Turiaf,101142,2013-14,606,31,24,11,10,1,5,24,8,12,12,1195,11.24173402,549,65,1,0.392324478
Dante Cunningham,201967,2013-14,1635,81,83,32,26,6,32,42,11,19,23,3238,15.51216903,2223,183,9,0.449459115
Kevin Love,201567,2013-14,2797,77,341,57,39,18,191,196,73,81,115,5765,28.61018993,4655,697,27,0.597288201
Al-Farouq Aminu,202329,2013-14,2045,80,114,18,17,1,56,88,27,45,43,3895,14.33021807,1807,240,11,0.403086922
Tyreke Evans,201936,2013-14,2028,72,363,109,71,38,130,175,55,84,91,3883,27.31387192,2482,690,21,0.769973835
Darius Miller,203121,2013-14,723,45,43,9,8,1,19,22,8,9,13,1380,12.87636131,503,83,2,0.400669148
Anthony Morrow,201627,2013-14,1426,76,59,13,11,2,30,51,17,16,35,2721,19.17545542,803,101,8,0.363327877
Melvin Ely,2408,2013-14,27,2,0,0,0,0,0,0,0,0,0,46,11.76470588,19,1,0,0
Jeff Withey,203481,2013-14,684,58,26,6,4,2,13,20,3,11,9,1315,12.18206158,774,46,0,0.374118884
Luke Babbitt,202337,2013-14,473,27,29,10,7,3,14,15,4,6,9,889,17.71144279,530,43,5,0.294252874
Eric Gordon,201569,2013-14,2057,64,208,28,18,10,78,134,38,51,83,4004,23.05671119,1497,418,16,0.452248063
Jrue Holiday,201950,2013-14,1143,34,268,68,53,15,124,105,46,38,67,2237,22.60802469,2086,521,14,0.875964494
Jason Smith,201160,2013-14,830,31,29,7,4,3,7,28,6,17,11,1593,18.1372549,1129,74,1,0.173174263
Brian Roberts,203148,2013-14,1667,72,234,55,40,15,90,95,43,32,63,3204,20.20509978,2832,486,13,0.528424016
Anthony Davis,203076,2013-14,2358,67,105,28,21,7,36,109,20,64,45,4539,25.39713289,2204,204,8,0.317648776
Austin Rivers,203085,2013-14,1339,69,160,46,35,11,57,77,27,30,47,2522,21.63279366,2019,326,11,0.511884808
James Southerland,203480,2013-14,30,4,0,0,0,0,0,1,1,0,1,59,24.28571429,26,1,0,0
Ryan Anderson,201583,2013-14,795,22,17,4,2,2,7,20,2,9,11,1548,21.89218922,722,51,5,0.265180219
Alexis Ajinca,201582,2013-14,951,56,40,8,6,2,18,63,13,35,28,1804,16.74008811,1155,80,3,0.321904565
Lamar Odom,1885,2013-14,0,0,0,0,0,0,0,0,0,0,0,0,0,0,0,0,0
Samuel Dalembert,2223,2013-14,1614,80,38,15,14,1,10,89,13,57,32,3128,15.07823613,1274,96,8,0.339543988
Shane Larkin,203499,2013-14,489,48,71,23,18,5,16,39,15,17,22,954,17.09796673,861,145,15,0.027928253
Jose Calderon,101181,2013-14,2468,81,377,97,65,32,132,103,56,31,72,4837,16.23773375,5053,770,63,0.505462253
Wayne Ellington,201961,2013-14,393,45,19,7,4,3,7,11,5,2,9,800,15.49450549,343,41,3,0.130781499
Amar'e Stoudemire,2405,2013-14,1466,65,34,17,16,1,7,91,8,65,26,2708,24.12781219,1141,101,4,0.43472472
Kenyon Martin,2030,2013-14,633,32,50,10,9,1,19,26,8,16,10,1163,12.03351104,660,98,5,0.421764712
Jeremy Tyler,202719,2013-14,398,41,8,5,4,1,1,26,4,14,12,774,18.68629672,263,19,1,0.262820513
Tim Hardaway Jr.,203501,2013-14,1875,81,66,23,15,8,26,47,13,20,27,3605,19.18746941,1389,137,9,0.389300323
Carmelo Anthony,2546,2013-14,2982,77,242,108,74,34,84,198,51,109,89,5615,32.27116526,3175,528,35,0.653585033
JR Smith,2747,2013-14,2421,74,219,89,56,33,76,108,33,42,66,4561,21.69793077,2735,493,34,0.600278424
Pablo Prigioni,203143,2013-14,1283,66,228,83,64,19,66,60,35,17,43,2351,9.595202399,2632,506,24,0.667923943
Iman Shumpert,202697,2013-14,1962,74,129,50,38,12,44,79,18,46,33,3635,14.32685385,1791,290,20,0.565837404
Toure' Murry,203315,2013-14,372,51,49,12,12,0,26,34,12,16,18,747,21.36953955,527,122,6,0.265706283
Shannon Brown,200769,2013-14,251,29,9,2,2,0,2,18,4,11,7,501,16.8157424,237,24,1,-0.018518519
Cole Aldrich,202332,2013-14,330,46,14,5,3,2,6,18,2,11,7,642,12.65306122,427,25,3,0.322751323
Andrea Bargnani,200745,2013-14,1257,42,45,15,12,3,11,58,11,35,23,2361,22.37426036,1222,118,10,0.302697852
Russell Westbrook,201566,2013-14,1412,46,319,81,52,29,137,177,70,77,100,2894,33.36374696,2177,622,36,0.88795253
Caron Butler,2406,2013-14,1394,55,82,28,22,6,30,60,18,32,28,2769,20.32258065,1486,159,13,0.439487097
Perry Jones III,203103,2013-14,765,62,26,7,6,1,8,21,6,9,12,1495,13.02816901,597,45,4,0.187313967
Nick Collison,2555,2013-14,1353,81,104,32,30,2,45,71,22,35,36,2651,11.72778328,2131,222,11,0.506293463
Kendrick Perkins,2570,2013-14,1207,62,67,14,9,5,34,91,20,55,36,2381,11.74058889,1464,113,5,0.422022784
Derek Fisher,965,2013-14,1428,81,117,21,15,6,48,49,26,14,35,2803,13.91167192,1626,255,14,0.353713015
Grant Jerrett,203511,2013-14,0,0,0,0,0,0,0,0,0,0,0,0,0,0,0,0,0
Serge Ibaka,201586,2013-14,2666,81,85,37,26,11,29,122,20,75,47,5333,19.74775971,2709,185,15,0.452405185
Jeremy Lamb,203087,2013-14,1538,78,115,35,31,4,41,61,20,21,40,3010,20.21461717,1211,225,11,0.441047747
Steven Adams,203500,2013-14,1197,81,43,11,11,0,13,71,9,42,29,2352,11.76255038,1161,73,4,0.212518595
Reggie Jackson,202704,2013-14,2277,80,331,93,58,35,109,168,58,73,95,4513,22.72993556,3268,702,36,0.611557183
Andre Roberson,203460,2013-14,399,40,15,1,1,0,6,19,4,10,9,790,10.17699115,284,41,5,-0.024561404
Thabo Sefolosha,200757,2013-14,1584,61,94,16,11,5,40,55,17,26,29,3164,11.96413561,1165,188,15,0.366714031
Hasheem Thabeet,201934,2013-14,192,23,1,0,0,0,1,14,2,8,6,393,9.198113208,118,8,1,0.523809524
Kevin Durant,201142,2013-14,3122,81,445,114,68,46,188,285,98,96,189,6270,32.57682549,3088,851,25,0.6724303
Doron Lamb,203117,2013-14,695,53,43,17,8,9,6,27,10,17,10,1328,13.37325349,561,88,5,0.361575048
Kyle O'Quinn,203124,2013-14,1188,69,78,14,10,4,44,78,21,47,31,2320,18.66359447,1628,174,5,0.531122031
Dewayne Dedmon,203473,2013-14,390,31,5,2,1,1,1,18,5,9,9,756,13.2032147,452,20,1,0.1
Arron Afflalo,201167,2013-14,2552,73,248,75,56,19,84,146,40,75,71,4972,23.22036937,2900,553,45,0.553077687
Victor Oladipo,203506,2013-14,2487,80,327,74,50,24,114,256,85,102,154,4885,24.43794553,3698,780,40,0.565625086
Nikola Vucevic,202696,2013-14,1812,57,104,37,30,7,36,112,26,73,39,3542,21.73153693,2662,215,17,0.451938078
Ronnie Price,101179,2013-14,377,31,66,11,7,4,19,26,13,7,19,722,15.38461538,561,127,8,-0.122377622
Tobias Harris,202699,2013-14,1850,61,82,27,13,14,28,78,12,43,35,3583,22.18379447,1840,156,9,0.356932657
Jameer Nelson,2749,2013-14,2179,68,476,113,62,51,161,166,62,66,100,4244,20.07108509,3667,1008,42,0.778975329
Maurice Harkless,203090,2013-14,1950,80,80,19,12,7,32,86,18,52,34,3790,14.7957993,1383,190,13,0.40720212
Andrew Nicholson,203094,2013-14,1174,76,25,13,12,1,6,51,7,32,19,2276,19.5884448,981,62,9,0.418495379
Jason Maxiell,101131,2013-14,488,34,9,2,1,1,6,14,1,9,5,945,12.34911792,432,27,4,0.436507937
E'Twaun Moore,202734,2013-14,1506,79,112,21,13,8,40,55,21,25,30,2954,16.26360339,1299,260,20,0.402288069
Michael Carter-Williams,203487,2013-14,2414,70,441,135,107,28,184,247,99,98,149,4978,25.67922875,4192,888,56,0.768629299
Nerlens Noel,203457,2013-14,0,0,0,0,0,0,0,0,0,0,0,0,0,0,0,0,0
Arnett Moultrie,203102,2013-14,187,12,2,0,0,0,1,7,1,5,2,396,10.32967033,211,10,1,0.071428571
Adonis Thomas,203519,2013-14,38,6,3,0,0,0,1,1,0,1,0,71,18.07228916,23,4,0,0
Tony Wroten,203100,2013-14,1765,72,217,46,35,11,125,204,62,108,96,3642,27.68604929,2299,452,38,0.750520227
James Anderson,202341,2013-14,2309,80,149,55,41,14,60,106,34,47,59,4775,15.87708067,1615,347,21,0.618086344
Casper Ware,203810,2013-14,116,9,10,1,0,1,4,5,3,2,3,236,19.30501931,200,17,2,-0.033333333
Brandon Davies,203561,2013-14,575,51,28,8,6,2,13,35,10,19,16,1166,14.00749064,699,71,3,0.489337652
Thaddeus Young,201152,2013-14,2718,79,182,43,32,11,105,165,46,70,95,5596,24.22535211,3756,404,21,0.544134228
Jason Richardson,2202,2013-14,0,0,0,0,0,0,0,0,0,0,0,0,0,0,0,0,0
Elliot Williams,202343,2013-14,1157,67,72,25,17,8,30,68,23,35,33,2386,16.78295997,943,169,8,0.594073536
Byron Mullens,201957,2013-14,414,45,14,8,6,2,3,27,6,13,14,834,21.21848739,543,26,3,0.279541446
Hollis Thompson,203138,2013-14,1742,77,73,29,16,13,25,60,27,24,36,3543,11.33235005,1304,178,11,0.445077162
Henry Sims,203156,2013-14,875,46,52,15,12,3,27,41,11,24,17,1739,18.44853307,922,119,4,0.601214837
Jarvis Varnado,202363,2013-14,339,24,13,8,8,0,2,10,3,5,5,689,12.23958333,366,24,0,0.269230769
Goran Dragic,201609,2013-14,2668,76,447,196,131,65,148,213,71,88,125,5302,24.52830189,4193,986,60,0.845342503
Eric Bledsoe,202339,2013-14,1416,43,235,92,52,40,98,143,52,57,86,2841,24.89096573,2156,523,15,0.886640237
Ish Smith,202397,2013-14,1007,70,179,71,52,19,70,65,32,23,42,1995,15.82167832,1818,363,15,0.799138179
Channing Frye,101112,2013-14,2312,82,98,44,27,17,37,89,21,59,30,4589,17.47068999,2980,188,17,0.525239856
Leandro Barbosa,2571,2013-14,368,20,32,16,11,5,6,19,4,10,9,724,19.97607656,336,70,2,0.19627193
Markieff Morris,202693,2013-14,2153,81,144,58,33,25,66,147,37,76,71,4315,23.24159021,2076,313,14,0.6629293
Gerald Green,101123,2013-14,2330,82,122,45,26,19,46,145,42,72,73,4688,23.65286444,1737,254,18,0.49999422
Marcus Morris,202694,2013-14,1800,82,88,23,12,11,38,95,30,50,45,3581,20.16308377,1755,188,9,0.4135207
PJ Tucker,200782,2013-14,2490,81,141,54,38,16,53,102,29,63,39,5008,14.12587413,2241,327,12,0.575323237
Archie Goodwin,203462,2013-14,533,52,20,7,7,0,8,44,10,16,28,1076,19.08646003,479,54,3,0.41859364
Alex Len,203458,2013-14,362,42,4,2,1,1,1,26,5,15,11,734,13.96449704,374,16,0,0.275641026
Miles Plumlee,203101,2013-14,1964,80,43,18,18,0,10,111,25,64,47,3882,16.39046538,2274,133,4,0.302894504
Dionte Christmas,202091,2013-14,198,31,8,3,3,0,4,6,1,3,3,398,16.84210526,202,26,1,0.375
Shavlik Randolph,101183,2013-14,95,14,1,0,0,0,0,5,1,3,2,182,11.32075472,88,6,0,-0.466666667
Emeka Okafor,2731,2013-14,0,0,0,0,0,0,0,0,0,0,0,0,0,0,0,0,0
Damian Lillard,203081,2013-14,2937,82,457,157,110,47,145,193,100,58,135,5839,24.82564179,5053,953,71,0.607419149
Dorell Wright,2748,2013-14,984,68,64,26,14,12,19,39,17,11,28,1945,16.27802691,982,137,4,0.409214271
Wesley Matthews,202083,2013-14,2780,82,197,51,36,15,58,110,33,51,59,5501,19.58052903,2520,405,44,0.347576019
CJ McCollum,203468,2013-14,476,38,27,10,7,3,6,35,10,16,19,939,20.79927339,422,56,2,0.078306878
Will Barton,203115,2013-14,387,41,33,11,8,3,15,18,4,9,9,768,21.42857143,431,65,8,0.287878788
Meyers Leonard,203086,2013-14,355,40,18,7,6,1,4,15,4,8,7,718,14.07588739,406,49,3,0.122222222
LaMarcus Aldridge,200746,2013-14,2499,69,178,90,57,33,60,123,23,70,53,4926,29.96839888,2930,391,43,0.655641544
Earl Watson,2248,2013-14,161,24,28,6,3,3,9,17,12,4,13,317,8.219178082,311,60,1,-0.052521008
Victor Claver,201964,2013-14,184,21,12,3,2,1,9,11,3,6,5,359,14.5,181,23,2,0.515151515
Joel Freeland,200777,2013-14,727,52,36,22,17,5,7,32,7,16,16,1416,12.37298267,633,78,7,0.536068538
Allen Crabbe,203459,2013-14,100,15,6,3,1,2,1,3,1,0,3,206,15.54621849,87,17,0,0
Mo Williams,2590,2013-14,1833,74,321,95,62,33,110,149,68,54,95,3627,20.40816327,3088,669,34,0.674388514
Thomas Robinson,203080,2013-14,873,70,34,12,8,4,12,57,14,31,26,1699,19.79949875,908,83,3,0.406986384
Robin Lopez,201577,2013-14,2604,82,73,30,23,7,23,84,18,42,42,5117,14.14107324,1883,191,11,0.400809974
Nicolas Batum,201587,2013-14,2956,82,420,106,75,31,170,208,105,79,129,5863,16.47492625,4395,785,50,0.561252383
Ray McCallum,203492,2013-14,897,45,120,26,20,6,40,39,16,16,23,1729,17.83216783,1456,259,8,0.486710331
Quincy Acy,203112,2013-14,848,63,28,8,6,2,10,30,7,17,13,1652,10.17745303,970,73,2,0.326422003
Rudy Gay,200752,2013-14,2495,72,209,51,38,13,93,224,64,85,139,4948,27.52053119,2359,457,28,0.525709132
Jared Cunningham,203099,2013-14,80,13,8,3,2,1,1,2,0,2,0,159,17.03296703,73,9,3,0.166666667
Derrick Williams,202682,2013-14,1799,77,56,16,9,7,29,76,10,43,33,3596,16.21556307,1564,124,7,0.473712322
DeMarcus Cousins,202326,2013-14,2277,70,207,62,47,15,98,252,56,137,115,4519,32.73007316,2749,421,13,0.625536126
Ben McLemore,203463,2013-14,2169,81,82,16,10,6,38,96,27,41,55,4312,16.86844229,1422,187,7,0.351950798
Isaiah Thomas,202738,2013-14,2463,71,454,104,74,30,174,213,76,81,132,4962,25.74067619,4271,939,28,0.673525921
Carl Landry,201171,2013-14,233,18,5,1,1,0,2,9,2,5,4,465,14.17769376,240,19,0,0.118518519
Travis Outlaw,2566,2013-14,1065,63,48,12,5,7,23,26,9,12,14,2093,15.70179092,798,100,8,0.435556151
Reggie Evans,2501,2013-14,899,54,21,8,5,3,7,58,9,41,17,1724,13.47588265,798,58,1,0.420449065
Jason Terry,1891,2013-14,544,34,56,16,12,4,20,27,15,9,18,1098,14.70823341,579,101,7,0.447402039
Aaron Gray,201189,2013-14,348,36,22,4,4,0,14,31,7,23,8,693,12.6394052,409,49,1,0.398826979
Jason Thompson,201574,2013-14,1979,81,53,15,12,3,21,95,15,57,38,3901,14.60923623,2178,156,7,0.363031651
Willie Reed,203186,2013-14,0,0,0,0,0,0,0,0,0,0,0,0,0,0,0,0,0
Kawhi Leonard,202695,2013-14,1923,66,133,51,34,17,49,80,16,44,36,3803,18.30819981,1854,257,27,0.540810913
Marco Belinelli,201158,2013-14,2016,80,179,61,34,27,69,95,40,40,55,3969,19.03035795,2164,309,53,0.496006131
Danny Green,201980,2013-14,1651,68,104,17,13,4,48,76,32,30,46,3275,16.45810664,1887,198,17,0.314768055
Cory Joseph,202709,2013-14,936,68,114,34,29,5,28,43,15,21,22,1844,17.22113503,1522,217,19,0.414396845
Damion James,202345,2013-14,50,5,3,0,0,0,1,1,1,0,1,100,9.649122807,63,9,1,-0.333333333
Patty Mills,201988,2013-14,1527,81,149,56,39,17,55,63,31,19,44,3027,22.39858907,2655,330,40,0.519232682
Tony Parker,2225,2013-14,1997,68,388,121,83,38,139,151,42,80,71,3942,26.63636364,3798,845,65,0.825657088
Jeff Ayres,201965,2013-14,952,73,60,21,13,8,18,63,22,33,30,1893,12.31203008,1241,105,8,0.352839812
Matt Bonner,2588,2013-14,690,61,31,15,11,4,7,16,5,10,6,1366,12.13307241,910,55,6,0.391493791
Aron Baynes,203382,2013-14,491,53,34,9,6,3,10,36,11,18,18,977,18.84057971,485,56,2,0.058823529
Manu Ginobili,1938,2013-14,1550,68,293,81,45,36,139,139,75,52,87,3122,24.39446367,2010,550,51,0.837357366
Tim Duncan,1495,2013-14,2158,74,220,45,35,10,112,159,51,67,92,4239,25.49143944,3093,350,18,0.462776869
Tiago Splitter,201168,2013-14,1271,59,90,23,15,8,49,75,23,36,39,2521,17.55994358,1610,191,8,0.562242247
Austin Daye,201948,2013-14,148,22,8,1,1,0,5,5,4,1,4,300,22.74052478,232,23,4,0.15
Boris Diaw,2564,2013-14,1974,79,222,65,30,35,93,121,39,58,63,3892,17.11378353,3073,439,17,0.570072886
Landry Fields,202361,2013-14,294,29,20,7,4,3,9,11,4,5,6,616,12.21910112,322,36,1,0.284848485
Nando De Colo,201986,2013-14,494,47,65,22,13,9,24,35,15,12,23,964,18.4950136,688,132,12,0.155311355
Kyle Lowry,200768,2013-14,2828,78,586,147,86,61,216,195,89,73,122,5553,22.63174404,5270,1117,60,0.684506826
DeMar DeRozan,201942,2013-14,2982,78,313,160,111,49,82,176,44,67,109,5704,28.26020719,2769,658,53,0.691678403
Dwight Buycks,202779,2013-14,146,14,10,5,4,1,3,10,4,3,7,278,18.42900302,218,27,4,0.233333333
Amir Johnson,101161,2013-14,2181,76,115,29,23,6,43,123,32,69,54,4206,16.52480797,2770,250,10,0.351291186
Steve Novak,200779,2013-14,540,54,13,6,4,2,6,5,0,4,1,1071,12.38793806,531,29,2,0.631394563
Jonas Valanciunas,202685,2013-14,2266,80,57,17,12,5,21,136,15,84,52,4348,18.63792061,2596,130,10,0.313329209
Greivis Vasquez,202349,2013-14,1765,78,323,90,61,29,124,128,65,43,85,3353,21.64412071,3418,658,43,0.673165972
John Salmons,2422,2013-14,1699,77,147,55,38,17,40,54,25,20,34,3298,12.96101159,1563,321,15,0.497357575
Terrence Ross,203082,2013-14,2137,80,79,16,12,4,40,88,32,38,50,4158,18.64048976,1380,161,21,0.378139414
Chuck Hayes,101236,2013-14,732,60,35,13,10,3,13,33,10,15,18,1435,10.40669856,885,85,6,0.439871044
Tyler Hansbrough,201946,2013-14,962,63,17,10,7,3,3,47,6,30,17,1870,14.85374771,997,55,3,0.423143227
Patrick Patterson,202335,2013-14,1506,64,78,37,25,12,23,65,16,42,23,2934,17.40806643,1917,155,10,0.501725868
Julyan Stone,202933,2013-14,120,21,12,6,3,3,4,5,1,3,2,226,8.914728682,207,35,0,0.366666667
Enes Kanter,202683,2013-14,2138,80,75,31,27,4,19,144,23,84,60,4026,23.44456405,2072,205,10,0.389266672
Marvin Williams,101107,2013-14,1674,66,78,29,16,13,29,53,16,26,27,3171,17.0533967,1819,186,8,0.453810186
Trey Burke,203504,2013-14,2262,70,396,100,64,36,155,131,67,42,89,4313,21.90827191,4347,817,38,0.633273458
John Lucas III,101249,2013-14,591,42,42,11,9,2,20,22,6,14,8,1144,16.25468165,1003,127,8,0.62505994
Diante Garrett,203197,2013-14,1048,71,120,37,22,15,42,75,37,31,44,1960,15.36412078,1901,290,13,0.55871329
Alec Burks,202692,2013-14,2193,78,212,57,44,13,78,149,49,66,83,4178,23.71369295,2883,495,29,0.515191137
Derrick Favors,202324,2013-14,2201,73,91,35,26,9,31,129,35,66,63,4179,21.02704987,2953,224,11,0.406777679
Gordon Hayward,202330,2013-14,2800,77,400,132,90,42,159,212,81,97,115,5339,23.11359527,3894,910,57,0.772041917
Ian Clark,203546,2013-14,172,23,15,2,1,1,10,14,8,6,8,335,21.3740458,171,26,2,0.276190476
Malcolm Thomas,202952,2013-14,63,8,2,1,1,0,0,9,0,5,4,129,18.18181818,93,6,1,0.018518519
Richard Jefferson,2210,2013-14,2213,82,130,34,27,7,63,93,36,39,54,4185,17.32116323,2184,283,25,0.476731585
Brandon Rush,201575,2013-14,418,38,24,8,3,5,7,20,10,8,12,795,12.01298701,404,61,3,0.091666667
Rudy Gobert,203497,2013-14,434,45,7,1,1,0,4,32,6,18,14,838,13.87755102,386,25,1,0.235119048
Erik Murphy,203513,2013-14,62,24,2,0,0,0,1,2,0,0,2,124,10.56338028,105,5,0,-0.166666667
Jeremy Evans,202379,2013-14,1209,66,44,12,8,4,15,40,15,17,23,2270,15.45245399,1532,111,5,0.252902086
Trevor Ariza,2772,2013-14,2690,76,191,50,33,17,85,132,48,58,74,5387,17.58802238,2711,374,30,0.463594193
John Wall,202322,2013-14,2945,81,721,247,135,112,298,295,131,108,187,5876,27.07831325,5793,1446,76,0.95187512
Bradley Beal,203078,2013-14,2494,72,243,58,39,19,78,128,52,50,78,4874,24.49385394,2704,440,42,0.362357758
Marcin Gortat,101162,2013-14,2620,80,138,41,31,10,33,126,28,65,61,5199,18.12457454,3400,322,20,0.259129535
Al Harrington,1733,2013-14,497,33,28,8,6,2,13,34,7,23,11,986,23.02158273,568,54,3,0.308823529
Martell Webster,101110,2013-14,2127,77,97,24,16,8,46,58,19,29,29,4169,14.76524325,1900,189,17,0.409980715
Kevin Seraphin,202338,2013-14,578,53,17,8,7,1,5,41,6,22,19,1091,21.71837709,580,52,3,0.456521575
Glen Rice,203318,2013-14,0,0,0,0,0,0,0,0,0,0,0,0,0,0,0,0,0
Garrett Temple,202066,2013-14,638,74,72,29,20,9,21,42,22,14,28,1213,14.3982808,1132,164,21,0.540818506
Otto Porter Jr.,203490,2013-14,319,37,10,3,3,0,2,14,7,5,9,613,15.1810585,290,31,1,-0.047619048
Andre Miller,1889,2013-14,968,57,197,55,40,15,94,61,34,16,45,1853,15.30516432,1601,349,18,0.755636152
Chris Singleton,202698,2013-14,250,25,6,0,0,0,6,17,1,13,4,479,17.26618705,286,18,1,0.588235294
Trevor Booker,202344,2013-14,1529,71,64,29,22,7,24,58,17,27,31,2978,14.45289643,2011,144,12,0.482416115
Nene ,2403,2013-14,1560,53,153,35,24,11,67,117,25,67,50,3064,24.13592797,1725,328,10,0.591284529
Drew Gooden,2400,2013-14,377,21,15,3,2,1,10,18,2,12,6,741,20.61978546,492,54,3,0.422222222