Name,EntityId,Season,Assists,X3ptAssists,Arc3Assists,Corner3Assists,AtRimAssists,Turnovers,BadPassTurnovers,DeadBallTurnovers,LiveBallTurnovers,OffPoss,Usage
Justin Anderson,1626147,2018-19,23,11,8,3,7,23,6,12,11,999,17.33333333
Kevin Huerter,1628989,2018-19,214,96,63,33,92,109,55,40,69,4391,15.74332403
Omari Spellman,1629016,2018-19,47,22,18,4,20,31,12,15,16,1734,15.06361323
Isaac Humphries,1629353,2018-19,0,0,0,0,0,0,0,0,0,127,14.38356164
Jaylen Adams,1629121,2018-19,65,34,24,10,25,28,12,10,18,924,13.55769231
Trae Young,1629027,2018-19,653,263,159,104,336,308,161,92,216,5400,28.41538963
Taurean Prince,1627752,2018-19,118,47,22,25,52,100,39,40,60,3368,19.38963431
Dewayne Dedmon,203473,2018-19,90,34,27,7,41,84,26,42,42,3394,17.01686122
Vince Carter,1713,2018-19,87,35,27,8,39,48,22,19,29,2877,16.98877805
Miles Plumlee,203101,2018-19,17,6,5,1,6,10,5,3,7,378,17.18377088
John Collins,1628381,2018-19,121,46,28,18,54,120,28,65,55,3916,23.50332594
Alex Poythress,1627816,2018-19,17,11,9,2,2,13,0,12,1,651,14.53804348
Kent Bazemore,203145,2018-19,152,64,40,24,68,121,56,40,81,3546,22.04020849
Alex Len,203458,2018-19,86,33,29,4,34,97,20,67,30,3359,22.01882845
DeAndre' Bembry,1627761,2018-19,202,92,56,36,97,141,54,52,89,4148,17.34607219
Jayson Tatum,1628369,2018-19,168,76,56,20,61,122,28,68,54,5052,22.26742129
Jaylen Brown,1627759,2018-19,100,43,35,8,36,99,22,55,44,3968,22.08726946
Brad Wanamaker,202954,2018-19,56,17,11,6,21,19,10,7,12,723,16.68711656
Kyrie Irving,202681,2018-19,464,165,126,39,167,172,80,54,118,4650,29.17551651
Terry Rozier,1626179,2018-19,231,107,86,21,77,68,32,20,48,3665,18.63099542
Marcus Morris,202694,2018-19,109,41,27,14,45,92,21,52,40,4318,20.92058885
Gordon Hayward,202330,2018-19,244,104,78,26,91,105,41,43,62,3887,18.8588451
Daniel Theis,1628464,2018-19,68,30,23,7,19,33,6,23,10,1884,15.54211261
RJ Hunter,1626154,2018-19,3,2,2,0,1,0,0,0,0,53,22.58064516
Guerschon Yabusele,1627824,2018-19,15,8,7,1,5,15,3,12,3,523,17.28813559
Marcus Smart,203935,2018-19,321,121,101,20,126,123,63,43,80,4511,14.8111332
Semi Ojeleye,1628400,2018-19,23,12,10,2,6,19,7,10,9,1224,14.10998553
Al Horford,201143,2018-19,283,123,89,34,109,102,38,44,58,4054,19.27118265
Robert Williams III,1629057,2018-19,7,1,0,1,4,10,1,7,3,584,10.3500761
Aron Baynes,203382,2018-19,57,30,29,1,7,40,8,25,15,1700,15.22419187
PJ Dozier,1628408,2018-19,5,1,0,1,3,0,0,0,0,110,17.46031746
Rodions Kurucs,1629066,2018-19,52,19,16,3,28,77,19,44,33,2800,17.98925071
D'Angelo Russell,1626156,2018-19,563,196,146,50,311,253,114,82,171,5120,31.8236611
Jared Dudley,201162,2018-19,83,37,28,9,36,43,23,17,26,2486,10.73326249
Spencer Dinwiddie,203915,2018-19,311,125,79,46,130,152,52,77,75,4005,24.91723681
DeMarre Carroll,201960,2018-19,85,35,25,10,37,73,17,35,38,3546,18.73305398
Theo Pinson,1629033,2018-19,21,7,6,1,7,18,10,6,12,447,19.57773512
Joe Harris,203925,2018-19,181,74,49,25,82,121,50,49,72,4817,17.05383481
Shabazz Napier,203894,2018-19,143,51,39,12,73,66,24,30,36,2042,24.17204301
Alan Williams,1626210,2018-19,3,2,1,1,1,1,1,0,1,58,22.53521127
Ed Davis,202334,2018-19,61,34,31,3,14,64,9,43,21,2949,12.93078056
Treveon Graham,1626203,2018-19,34,15,11,4,13,17,4,12,5,1520,12.62304574
Caris LeVert,1627747,2018-19,156,80,67,13,54,69,30,25,44,2210,24.15033986
Rondae Hollis-Jefferson,1626178,2018-19,96,54,38,16,36,68,18,29,39,2602,21.51770658
Dzanan Musa,1629058,2018-19,2,1,1,0,1,4,2,2,2,86,25
Jarrett Allen,1628386,2018-19,110,63,52,11,31,103,26,57,46,4397,16.13098848
Allen Crabbe,203459,2018-19,46,15,10,5,21,46,10,33,13,2376,16.33184524
Miles Bridges,1628970,2018-19,95,34,27,7,40,50,19,17,33,3481,15.14919663
Malik Monk,1628370,2018-19,117,26,21,5,70,86,41,33,53,2618,24.48489011
Marvin Williams,101107,2018-19,92,40,28,12,35,47,12,25,22,4345,15.06318793
Jeremy Lamb,203087,2018-19,172,70,52,18,76,80,33,30,50,4583,22.56568779
Devonte' Graham,1628984,2018-19,121,36,27,9,59,30,12,13,17,1380,17.13917526
Nicolas Batum,201587,2018-19,247,105,72,33,89,117,69,32,85,4798,13.16371681
Shelvin Mack,202714,2018-19,183,61,45,16,63,66,36,17,49,2478,18.4046835
Dwayne Bacon,1628407,2018-19,47,26,19,7,14,18,5,11,7,1531,17.32007022
Bismack Biyombo,202687,2018-19,33,12,9,3,6,34,11,20,14,1549,13.23024055
Tony Parker,2225,2018-19,207,88,65,23,76,75,28,34,41,2071,25.49441101
Michael Kidd-Gilchrist,203077,2018-19,61,37,31,6,19,42,7,26,16,2381,15.88474326
Kemba Walker,202689,2018-19,484,196,122,74,184,211,90,60,151,5835,31.44501666
Joe Chealey,1629147,2018-19,1,1,1,0,0,0,0,0,0,16,17.64705882
Cody Zeller,203469,2018-19,102,40,31,9,38,62,17,40,22,2564,16.26943005
Willy Hernangomez,1626195,2018-19,60,24,16,8,26,58,17,27,31,1697,21.28966223
Frank Kaminsky,1626163,2018-19,63,24,12,12,24,41,10,22,19,1552,22.22867092
J.P. Macura,1629122,2018-19,2,0,0,0,1,0,0,0,0,36,21.95121951
Shaquille Harrison,1627885,2018-19,139,51,30,21,57,60,25,23,37,2935,16.44716692
Cristiano Felicio,1626245,2018-19,37,10,8,2,14,33,9,19,14,1530,14.13612565
Timothe Luwawu-Cabarrot,1627789,2018-19,26,2,0,2,15,21,5,11,10,1407,15.98489616
Zach LaVine,203897,2018-19,283,87,64,23,106,215,86,81,134,4465,30.23958124
Antonio Blakeney,1628469,2018-19,42,17,17,0,15,35,13,10,25,1703,24.60063898
Wayne Selden,1627782,2018-19,109,26,16,10,57,79,29,36,43,2932,18.36485662
Chandler Hutchison,1628990,2018-19,34,10,8,2,16,25,11,10,15,1828,12.41991129
Rawle Alkins,1628959,2018-19,13,5,3,2,6,8,1,5,3,250,17.80821918
Otto Porter Jr.,203490,2018-19,120,35,25,10,71,65,27,24,41,3547,18.9148073
Lauri Markkanen,1628374,2018-19,75,29,20,9,29,85,18,37,48,3417,25.04565614
Walter Lemon Jr.,1627215,2018-19,30,12,9,3,15,10,8,2,8,345,25.8974359
Kris Dunn,1627739,2018-19,277,108,80,28,105,104,37,55,49,2828,20.24073487
Wendell Carter Jr.,1628976,2018-19,78,39,27,12,27,65,12,40,25,2249,19.50925181
Robin Lopez,201577,2018-19,89,29,21,8,32,96,11,59,37,3284,18.72607983
Brandon Sampson,1629102,2018-19,10,6,5,1,3,12,4,5,7,438,15.59251559
Ryan Arcidiacono,1627853,2018-19,269,95,67,28,102,63,24,28,35,3980,11.95553539
Kevin Love,201567,2018-19,48,16,12,4,25,42,17,16,26,1219,26.5480427
Nik Stauskas,203917,2018-19,81,31,16,15,38,51,24,16,35,2084,17.69949066
Collin Sexton,1629012,2018-19,243,93,76,17,87,185,52,84,101,5246,25.34453782
Marquese Chriss,1627737,2018-19,22,12,11,1,6,36,9,23,13,1015,20.30848329
Jaron Blossomgame,1628417,2018-19,13,8,8,0,4,11,5,5,6,872,12.5
JR Smith,2747,2018-19,21,4,2,2,13,11,7,3,8,458,18.25242718
Jordan Clarkson,203903,2018-19,196,94,59,35,73,135,48,57,78,4469,27.38916256
Channing Frye,101112,2018-19,20,9,8,1,7,13,5,6,7,685,17.84776903
David Nwaba,1628021,2018-19,54,24,20,4,22,29,11,12,17,1954,14.64713715
Tristan Thompson,202684,2018-19,86,31,29,2,27,59,14,28,31,2365,17.95154185
Cedi Osman,1626224,2018-19,195,81,56,25,69,114,47,45,69,4898,18.68449584
Matthew Dellavedova,203521,2018-19,181,54,39,15,101,68,39,24,44,1657,17.87051899
Brandon Knight,202688,2018-19,71,37,26,11,21,30,11,16,14,1480,18.34034877
Larry Nance Jr.,1626204,2018-19,214,92,68,24,75,96,29,52,44,3576,15.59655597
John Henson,203089,2018-19,14,4,4,0,10,12,3,9,3,414,17.91044776
Deng Adel,1629061,2018-19,5,2,2,0,0,6,2,2,4,381,10.06864989
Ante Zizic,1627790,2018-19,53,26,23,3,13,61,6,37,24,2179,18.4114053
Courtney Lee,201584,2018-19,37,21,15,6,8,14,6,7,7,888,15.47131148
Daryl Macon,1629133,2018-19,7,3,3,0,3,6,4,2,4,185,16.98113208
J.J. Barea,200826,2018-19,211,78,61,17,112,72,36,24,48,1565,27.37961926
Dwight Powell,203939,2018-19,112,47,36,11,33,67,16,46,21,3384,17.35928459
Dorian Finney-Smith,1627827,2018-19,95,46,38,8,34,74,27,39,35,4040,14.04994571
Tim Hardaway Jr.,203501,2018-19,159,69,51,18,64,105,36,37,68,4248,25.10434057
Jalen Brunson,1628973,2018-19,230,95,68,27,91,88,40,29,59,3253,19.20043514
Trey Burke,203504,2018-19,159,68,58,10,58,49,22,22,27,2302,24.93287303
Devin Harris,2734,2018-19,122,53,40,13,46,56,24,22,34,2166,18.82113821
Kostas Antetokounmpo,1628961,2018-19,0,0,0,0,0,1,0,0,1,22,24
Dirk Nowitzki,1717,2018-19,35,13,9,4,12,18,4,7,11,1626,22.66960838
Maxi Kleber,1628467,2018-19,70,40,31,9,24,54,26,20,34,3039,13.69546374
Justin Jackson,1628382,2018-19,96,26,22,4,45,28,8,11,17,3395,14.37582129
Ryan Broekhoff,1629151,2018-19,22,8,6,2,11,16,9,5,11,930,14.38223938
Salah Mejri,1626257,2018-19,35,11,8,3,7,21,3,11,10,811,16.03053435
Luka Doncic,1629029,2018-19,429,190,110,80,193,247,118,91,156,4770,30.54059075
Isaiah Thomas,202738,2018-19,23,7,5,2,10,18,8,7,11,390,28.35164835
Torrey Craig,1628470,2018-19,72,32,23,9,25,44,14,26,18,3015,12.51428571
Paul Millsap,200794,2018-19,141,60,48,12,54,95,27,39,56,3839,19.63038089
Will Barton,203115,2018-19,124,38,23,15,51,65,22,25,40,2424,20.02164502
Brandon Goodwin,1629164,2018-19,14,8,5,3,3,3,1,1,2,122,22.62773723
Trey Lyles,1626168,2018-19,87,29,24,5,39,68,22,29,39,2282,23.78190255
Jarred Vanderbilt,1629020,2018-19,3,0,0,0,2,8,2,6,2,159,18.18181818
Monte Morris,1628420,2018-19,297,123,94,29,123,52,25,20,32,3966,17.32335461
Gary Harris,203914,2018-19,127,44,37,7,57,68,22,33,35,3342,19.9739922
Nikola Jokic,203999,2018-19,580,173,122,51,265,248,84,109,139,5056,27.58205877
Tyler Lydon,1628399,2018-19,6,5,3,2,0,4,1,3,1,205,9.829059829
Mason Plumlee,203486,2018-19,243,83,61,22,96,125,48,60,65,3466,16.51976832
Malik Beasley,1627736,2018-19,97,31,24,7,45,55,18,21,34,3840,18.68433074
Jamal Murray,1627750,2018-19,363,135,103,32,129,158,68,49,109,4954,24.87247142
Juancho Hernangomez,1627823,2018-19,55,25,19,6,19,37,8,12,25,2749,12.18819072
Thomas Welsh,1629118,2018-19,5,1,1,0,2,1,0,0,1,87,15.30612245
Andre Drummond,203083,2018-19,112,50,38,12,40,175,24,103,72,5335,23.15875614
Reggie Jackson,202704,2018-19,344,133,86,47,158,148,68,57,91,4609,24.34749476
Luke Kennard,1628379,2018-19,114,57,38,19,42,57,23,25,32,2863,18.52651048
Bruce Brown,1628971,2018-19,91,46,34,12,33,45,20,15,30,2885,11.70924574
Thon Maker,1627748,2018-19,45,17,10,7,17,33,6,21,12,1978,15.31895777
Langston Galloway,204038,2018-19,85,35,20,15,33,24,12,8,16,3547,15.88554514
Khyri Thomas,1629017,2018-19,8,3,2,1,5,4,1,1,3,396,16.55913978
Ish Smith,202397,2018-19,203,106,69,37,69,61,22,21,40,2514,19.97926028
Svi Mykhailiuk,1629004,2018-19,37,7,4,3,22,21,12,4,17,938,16.15969582
Wayne Ellington,201961,2018-19,72,21,13,8,40,40,19,16,24,2613,17.0360569
Glenn Robinson III,203922,2018-19,21,14,9,5,4,18,7,5,13,1227,15.07823613
Blake Griffin,201933,2018-19,402,203,159,44,125,253,81,119,134,5316,30.3165183
Kalin Lucas,203564,2018-19,1,0,0,0,1,0,0,0,0,11,16.66666667
Zaza Pachulia,2585,2018-19,91,24,20,4,33,57,7,41,16,1751,15.31936128
Jon Leuer,202720,2018-19,14,4,3,1,3,23,2,16,7,809,16.38981174
Jose Calderon,101181,2018-19,115,52,31,21,45,35,19,12,23,1289,10.86065574
DeMarcus Cousins,202326,2018-19,107,41,36,5,47,72,20,39,33,1610,28.69318182
Damion Lee,1627814,2018-19,13,6,6,0,6,11,3,7,4,787,16.81818182
Jordan Bell,1628395,2018-19,76,29,18,11,21,42,8,26,16,1625,13.83095499
Quinn Cook,1626188,2018-19,116,29,20,9,44,50,20,24,26,2172,20.62111801
Kevon Looney,1626172,2018-19,123,54,38,16,21,51,14,30,21,3099,12.51059023
Andre Iguodala,2738,2018-19,216,73,50,23,90,52,21,27,25,3305,10.45182363
Jacob Evans,1628980,2018-19,23,6,5,1,7,11,5,2,9,422,13.67521368
Klay Thompson,202691,2018-19,186,49,23,26,96,115,36,58,57,5541,25.93259162
Andrew Bogut,101106,2018-19,11,3,3,0,6,8,2,4,4,280,15.15151515
Damian Jones,1627745,2018-19,28,6,3,3,5,16,3,11,5,838,11.52173913
Jonas Jerebko,201973,2018-19,96,39,32,7,21,43,19,19,24,2531,14.92227979
Draymond Green,203110,2018-19,454,161,122,39,178,169,92,63,106,4354,13.1496556
Alfonzo McKinnie,1628035,2018-19,31,14,12,2,11,30,10,16,14,2112,13.46313173
Stephen Curry,201939,2018-19,361,121,82,39,153,192,92,65,127,4997,29.63163597
Marcus Derrickson,1629094,2018-19,1,1,1,0,0,3,2,1,2,138,23.60248447
Shaun Livingston,2733,2018-19,114,47,35,12,37,38,18,16,22,1975,12.15121512
Kevin Durant,201142,2018-19,457,194,152,42,167,225,91,90,135,5714,28.90118577
Trevon Duval,1628979,2018-19,2,1,1,0,1,0,0,0,0,12,25
Iman Shumpert,202697,2018-19,112,42,28,14,46,50,20,18,32,3147,14.55571227
Chris Chiozza,1629185,2018-19,4,2,2,0,1,1,1,0,1,73,10.97560976
Chris Paul,101108,2018-19,473,235,160,75,195,152,85,47,105,3788,22.61567517
Danuel House Jr.,1627863,2018-19,40,21,13,8,16,35,9,18,17,1997,14.108252
Gary Clark,1629109,2018-19,18,12,9,3,6,7,5,1,6,1312,10.76716016
Eric Gordon,201569,2018-19,129,60,26,34,59,90,27,44,46,4395,21.99153396
Vincent Edwards,1629053,2018-19,0,0,0,0,0,0,0,0,0,33,11.11111111
James Harden,201935,2018-19,586,218,135,83,336,387,171,131,256,5778,40.35303147
Gerald Green,101123,2018-19,40,19,8,11,18,55,21,21,34,3014,19.56586381
Clint Capela,203991,2018-19,96,51,29,22,28,94,18,49,45,4501,18.3989039
PJ Tucker,200782,2018-19,96,55,36,19,29,62,19,40,22,5636,9.641959799
Austin Rivers,203085,2018-19,167,88,56,32,49,68,22,31,37,4178,14.604811
Kenneth Faried,202702,2018-19,20,13,9,4,5,33,13,14,19,1515,19.98834499
Nene ,2403,2018-19,26,18,13,5,4,11,4,6,5,1121,11.89320388
Isaiah Hartenstein,1628392,2018-19,15,11,8,3,3,13,1,11,2,461,11.47227533
Darren Collison,201954,2018-19,459,149,118,31,167,125,65,37,88,4356,17.92918897
Aaron Holiday,1628988,2018-19,87,21,12,9,39,40,19,13,27,1355,21.32013201
Victor Oladipo,203506,2018-19,186,57,33,24,73,82,36,25,57,2309,28.26254826
Edmond Sumner,1628410,2018-19,10,1,0,1,4,10,3,6,4,455,16.15384615
Cory Joseph,202709,2018-19,321,106,78,28,135,80,47,24,56,4166,13.79604003
Kyle O'Quinn,203124,2018-19,56,17,14,3,28,30,11,16,14,786,20.04555809
Domantas Sabonis,1627734,2018-19,212,69,51,18,85,160,43,91,69,3721,23.30097087
Doug McDermott,203926,2018-19,67,17,14,3,32,42,19,19,23,2729,15.79116984
Thaddeus Young,201152,2018-19,204,70,46,24,92,123,44,55,68,4968,18.33512738
TJ Leaf,1628388,2018-19,24,9,6,3,8,12,2,6,6,1106,16.58692185
Wesley Matthews,202083,2018-19,160,60,41,19,78,91,36,34,57,4284,17.95193312
Alize Johnson,1628993,2018-19,1,0,0,0,1,0,0,0,0,147,11.83431953
Davon Reed,1628432,2018-19,3,2,1,1,0,1,1,0,1,105,10.56910569
Myles Turner,1626167,2018-19,115,37,23,14,50,100,27,53,47,4275,20.37076048
Bojan Bogdanovic,202711,2018-19,161,59,35,24,71,134,41,65,69,5223,22.39342578
Sindarius Thornwell,1628414,2018-19,18,7,6,1,7,20,8,9,11,675,11.30319149
Shai Gilgeous-Alexander,1628983,2018-19,270,114,85,29,114,141,65,55,86,4566,18.63268129
JaMychal Green,203210,2018-19,50,11,9,2,25,86,35,42,44,2811,19.15563957
Montrezl Harrell,1626149,2018-19,162,57,36,21,58,132,32,63,69,4576,23.3346395
Danilo Gallinari,201568,2018-19,178,63,40,23,67,99,41,40,59,4287,24.12638627
Tyrone Wallace,1627820,2018-19,42,14,11,3,18,36,14,16,20,1372,18
Jerome Robinson,1629010,2018-19,19,6,2,4,9,13,11,2,11,685,16.47058824
Johnathan Motley,1628405,2018-19,11,2,1,1,4,16,2,11,5,338,27.20207254
Garrett Temple,202066,2018-19,106,36,30,6,34,70,30,29,41,4121,13.45430405
Rodney McGruder,203585,2018-19,112,41,33,8,55,64,30,21,43,3179,15.11280239
Landry Shamet,1629013,2018-19,117,41,30,11,52,45,21,20,25,3794,14.87913635
Patrick Beverley,201976,2018-19,300,119,89,30,113,85,42,37,48,4463,12.2939424
Wilson Chandler,201163,2018-19,82,28,23,5,38,46,22,20,26,2467,11.86012978
Lou Williams,101150,2018-19,402,113,81,32,242,181,108,42,139,4308,31.63794893
Angel Delgado,1629116,2018-19,0,0,0,0,0,0,0,0,0,31,15.78947368
Ivica Zubac,1627826,2018-19,63,20,18,2,20,70,9,36,34,2212,20.42793702
Kyle Kuzma,1628398,2018-19,178,62,45,17,100,133,34,73,60,4954,23.80524614
Kentavious Caldwell-Pope,203484,2018-19,110,31,20,11,66,65,27,24,41,4325,17.98191533
Lonzo Ball,1628366,2018-19,255,61,45,16,160,103,51,39,64,3055,17.00819672
Josh Hart,1628404,2018-19,93,45,28,17,37,58,17,30,28,3682,13.3655006
Alex Caruso,1627936,2018-19,77,19,16,3,41,42,21,13,29,1108,19.23076923
Tyson Chandler,2199,2018-19,37,14,10,4,11,42,8,31,11,1858,8.705994291
Lance Stephenson,202362,2018-19,140,41,30,11,74,86,34,38,48,2419,20.36968577
JaVale McGee,201580,2018-19,52,20,16,4,24,108,31,58,50,3567,20.22862823
Rajon Rondo,200765,2018-19,367,127,95,32,180,127,64,56,71,2922,17.63262803
Jemerrio Jones,1629203,2018-19,13,8,8,0,3,5,1,3,2,295,10.95505618
Brandon Ingram,1627742,2018-19,154,48,34,14,79,129,42,52,77,3761,23.22565433
Moritz Wagner,1629021,2018-19,24,9,6,3,9,39,13,15,24,959,21.56862745
Isaac Bonga,1629067,2018-19,15,4,4,0,8,6,3,2,4,257,15.80756014
Johnathan Williams,1629140,2018-19,13,6,5,1,6,16,0,11,5,766,16.44295302
LeBron James,2544,2018-19,454,146,105,41,245,197,83,83,114,4142,31.8388564
Mike Muscala,203488,2018-19,76,34,29,5,32,48,21,23,25,2784,14.29489239
Reggie Bullock,203493,2018-19,129,49,32,17,53,65,28,24,41,3884,15.70285714
Avery Bradley,202340,2018-19,152,49,42,7,73,89,53,27,62,3937,16.38559708
Kyle Anderson,203937,2018-19,128,39,24,15,60,58,20,29,29,2520,13.04190751
Delon Wright,1626153,2018-19,248,126,77,49,64,77,30,28,49,3496,17.77665232
Jevon Carter,1628975,2018-19,69,27,24,3,27,33,12,15,18,1147,17.85440613
Julian Washburn,1627395,2018-19,14,5,3,2,7,7,2,3,4,496,9.930313589
Bruno Caboclo,203998,2018-19,50,20,15,5,20,38,12,16,22,1616,15.52287582
CJ Miles,101139,2018-19,36,6,4,2,23,30,11,13,17,1813,17.91338583
Justin Holiday,203200,2018-19,146,53,35,18,69,104,55,34,70,5292,15.66592958
Ivan Rabb,1628397,2018-19,54,20,16,4,27,35,10,15,20,1434,17.11990111
Mike Conley,201144,2018-19,449,143,103,40,196,130,71,34,96,4672,27.02650788
Yuta Watanabe,1629139,2018-19,8,4,3,1,4,6,1,5,1,358,15.19607843
Jaren Jackson Jr.,1628991,2018-19,64,24,17,7,26,98,14,58,40,2962,23.63747704
Jonas Valanciunas,202685,2018-19,70,26,19,7,24,90,27,45,45,2262,28.26086957
Tyler Dorsey,1628416,2018-19,56,26,15,11,24,27,8,15,12,1465,18.97590361
Dillon Brooks,1628415,2018-19,16,8,7,1,7,19,10,8,11,647,21.418637
Chandler Parsons,202718,2018-19,43,18,8,10,16,32,14,14,18,1003,20
Tyler Zeller,203092,2018-19,4,0,0,0,3,4,0,3,1,190,19.6347032
Joakim Noah,201149,2018-19,89,22,15,7,37,50,16,22,28,1392,19.82378855
Josh Richardson,1626196,2018-19,298,119,81,38,118,113,42,52,61,5130,20.94089674
Yante Maten,1628999,2018-19,0,0,0,0,0,0,0,0,0,27,13.33333333
Dwyane Wade,2548,2018-19,301,102,69,33,148,166,82,55,111,3883,27.7214334
Derrick Jones Jr.,1627884,2018-19,37,22,13,9,10,43,15,21,22,2301,15.68113772
Goran Dragic,201609,2018-19,174,56,43,13,87,71,31,28,43,2074,22.93423272
Kelly Olynyk,203482,2018-19,140,68,40,28,50,114,31,69,45,3678,17.97323136
Dion Waiters,203079,2018-19,121,60,36,24,41,64,25,33,31,2277,21.88841202
Bam Adebayo,1628389,2018-19,184,90,62,28,53,121,20,78,43,3859,16.21062313
James Johnson,201949,2018-19,135,66,54,12,50,74,20,41,33,2350,18.20917983
Justise Winslow,1626159,2018-19,282,116,80,36,119,142,76,44,98,3980,21.09219545
Hassan Whiteside,202355,2018-19,56,19,17,2,19,97,14,66,31,3380,22.12948912
Ryan Anderson,201583,2018-19,19,7,4,3,9,14,6,7,7,645,12.43093923
Udonis Haslem,2617,2018-19,2,0,0,0,2,3,1,2,1,162,21.11111111
Duncan Robinson,1629130,2018-19,5,0,0,0,3,4,2,2,2,336,13.82978723
George Hill,201588,2018-19,135,46,29,17,60,51,18,24,27,2681,15.18945634
D.J. Wilson,1628391,2018-19,52,28,20,8,14,32,16,13,19,1873,14.53765491
Eric Bledsoe,202339,2018-19,430,166,132,34,226,165,65,65,100,4854,22.95813953
Donte DiVincenzo,1628978,2018-19,31,10,8,2,17,19,6,9,10,887,14.8445336
Brook Lopez,201572,2018-19,98,45,34,11,37,82,27,42,40,4970,16.86152722
Tim Frazier,204025,2018-19,248,89,67,22,112,76,24,35,41,2378,13.53271028
Malcolm Brogdon,1627763,2018-19,205,90,61,29,91,91,38,41,50,3883,20.83140878
Pau Gasol,2200,2018-19,52,16,10,6,17,16,6,3,13,755,15.77669903
Tony Snell,203503,2018-19,68,20,13,7,38,23,10,9,14,2755,13.08196721
Khris Middleton,203114,2018-19,331,108,82,26,191,174,74,60,114,5130,25.09264161
Sterling Brown,1628425,2018-19,84,30,24,6,43,46,22,19,27,2219,15.34693878
Pat Connaughton,1626192,2018-19,122,53,39,14,48,33,11,17,16,2683,13.33998669
Giannis Antetokounmpo,203507,2018-19,424,245,179,66,135,268,49,165,103,5053,32.27248346
Nikola Mirotic,202703,2018-19,55,17,13,4,27,48,17,25,23,2702,21.14060964
Bonzie Colson,1629045,2018-19,3,0,0,0,3,3,0,2,1,225,17.62452107
Ersan Ilyasova,101141,2018-19,52,25,19,6,21,47,14,29,18,2606,15.58704453
Jeff Teague,201952,2018-19,343,119,84,35,144,97,43,38,59,2640,18.91538713
Tyus Jones,1626145,2018-19,327,127,104,23,121,47,30,14,33,3244,14.31318681
Jared Terrell,1629123,2018-19,12,7,5,2,5,10,6,3,7,230,20.23346304
Gorgui Dieng,203476,2018-19,72,28,23,5,27,57,12,30,27,2127,20.2606137
Jerryd Bayless,201573,2018-19,119,51,40,11,47,32,18,9,23,1327,17.83148269
Luol Deng,2736,2018-19,18,4,2,2,10,14,4,7,7,809,15.84051724
C.J. Williams,203710,2018-19,12,3,2,1,4,5,0,5,0,258,14.33691756
Cameron Reynolds,1629244,2018-19,13,5,4,1,5,5,0,4,1,536,14.4278607
Josh Okogie,1629006,2018-19,91,22,10,12,49,63,25,30,33,3712,15.23742027
Andrew Wiggins,203952,2018-19,184,86,55,31,53,138,39,59,79,5277,24.58063445
Derrick Rose,201565,2018-19,220,65,51,14,104,82,33,26,56,2939,26.84163436
Keita Bates-Diop,1628966,2018-19,17,3,2,1,9,14,4,5,9,1031,14.48157669
Karl-Anthony Towns,1626157,2018-19,259,79,57,22,138,240,64,142,98,5286,28.57142857
Robert Covington,203496,2018-19,46,17,10,7,19,46,13,28,18,2487,15.65585331
Dario Saric,203967,2018-19,127,45,26,19,50,97,28,43,54,4221,17.83479349
Anthony Tolliver,201229,2018-19,46,10,6,4,18,36,12,20,16,2242,12.52453867
Mitchell Creek,1628249,2018-19,6,2,2,0,2,1,1,0,1,98,17.54385965
Taj Gibson,201959,2018-19,84,32,27,5,28,73,12,42,31,3494,17.08829365
Ian Clark,203546,2018-19,94,22,14,8,46,58,18,22,36,2092,19.1480388
Stanley Johnson,1626169,2018-19,88,44,29,15,28,81,27,37,44,2499,19.42573555
Elfrid Payton,203901,2018-19,320,103,81,22,138,112,57,36,76,2697,18.18181818
Jahlil Okafor,1626143,2018-19,40,9,5,4,20,52,4,31,21,1968,20.33514493
Dairis Bertans,1629541,2018-19,10,3,3,0,5,2,1,1,1,361,12.37373737
Jrue Holiday,201950,2018-19,518,161,110,51,272,210,110,57,153,5128,25.39491758
Cheick Diallo,1627767,2018-19,33,15,12,3,13,49,11,25,24,1939,16.07554123
Frank Jackson,1628402,2018-19,69,20,16,4,27,48,26,21,27,2549,18.29861111
Darius Miller,203121,2018-19,146,44,29,15,68,59,28,28,31,3752,13.4392036
Anthony Davis,203076,2018-19,218,80,64,16,100,112,31,52,60,3937,29.32180851
Julius Randle,203944,2018-19,229,97,78,19,83,207,43,109,98,4754,27.9125764
Kenrich Williams,1629026,2018-19,83,30,21,9,36,36,19,12,24,2326,12.14742384
Christian Wood,1626174,2018-19,8,4,3,1,3,17,5,7,10,551,25.68659128
Solomon Hill,203524,2018-19,55,19,18,1,23,31,18,4,27,1863,10.59885932
E'Twaun Moore,202734,2018-19,102,31,24,7,49,59,21,21,38,3100,17.41588917
Kadeem Allen,1628443,2018-19,76,35,28,7,28,26,6,16,10,841,20.46908316
Emmanuel Mudiay,1626144,2018-19,228,108,81,27,94,140,62,48,92,3323,25.51669316
Luke Kornet,1628436,2018-19,54,18,13,5,20,25,15,7,18,1631,18.41074426
Billy Garrett,1628656,2018-19,7,3,2,1,3,2,1,1,1,133,21.9858156
Isaiah Hicks,1628439,2018-19,2,1,1,0,1,1,1,0,1,65,15.94202899
Dennis Smith Jr.,1628372,2018-19,252,115,82,33,102,154,76,56,98,3121,24.85746864
DeAndre Jordan,201599,2018-19,156,52,40,12,62,153,49,81,72,4199,15.17894737
Mario Hezonja,1626209,2018-19,88,25,19,6,53,88,32,43,45,2475,21.38543517
Frank Ntilikina,1628373,2018-19,121,42,35,7,51,56,27,23,33,1859,16.80993314
Henry Ellenson,1627740,2018-19,16,8,8,0,7,9,2,4,5,530,19.3877551
Allonzo Trier,1629019,2018-19,119,48,38,10,52,116,40,55,61,3009,21.45985401
Kevin Knox,1628995,2018-19,82,39,31,8,29,114,20,67,47,4484,22.41618726
Damyean Dotson,1628422,2018-19,135,67,51,16,43,71,32,26,45,4123,17.44186047
Mitchell Robinson,1629011,2018-19,37,9,8,1,7,35,7,21,14,2778,12.25662305
John Jenkins,203098,2018-19,22,7,5,2,12,9,7,2,7,675,16.6437414
Noah Vonleh,203943,2018-19,129,57,53,4,31,88,16,51,37,3541,14.82125124
Lance Thomas,202498,2018-19,27,9,7,2,13,24,5,15,9,1613,13.17829457
Russell Westbrook,201566,2018-19,784,294,196,98,358,325,173,106,219,5668,30.64169481
Raymond Felton,101109,2018-19,52,22,15,7,25,14,5,6,8,787,17.0893054
Nerlens Noel,203457,2018-19,45,22,18,4,19,47,14,19,28,2195,14.26863292
Markieff Morris,202693,2018-19,79,32,22,10,38,54,20,24,30,2663,19.49579832
Hamidou Diallo,1628977,2018-19,17,8,4,4,8,23,7,15,8,1110,16.44888547
Jawun Evans,1628393,2018-19,10,2,1,1,5,6,4,1,5,127,14.70588235
Jerami Grant,203924,2018-19,79,46,31,15,21,67,14,39,28,5603,15.21907416
Abdel Nader,1627846,2018-19,20,6,5,1,8,26,4,16,10,1470,15.31966224
Steven Adams,203500,2018-19,124,49,31,18,50,133,35,65,68,5748,16.22760801
Paul George,202331,2018-19,318,124,73,51,150,205,75,80,125,6060,29.1954023
Donte Grantham,1629055,2018-19,0,0,0,0,0,0,0,0,0,6,33.33333333
Dennis Schroder,203471,2018-19,323,119,90,29,167,172,93,47,125,4916,24.41530829
Terrance Ferguson,1628390,2018-19,72,33,14,19,27,47,14,26,21,4106,10.67857903
Deonte Burton,1629126,2018-19,9,7,2,5,2,9,3,4,5,509,16.29502573
Patrick Patterson,202335,2018-19,31,10,10,0,14,22,10,10,12,1826,12.18103033
Aaron Gordon,203932,2018-19,289,99,74,25,118,162,51,85,77,5328,21.87812188
Jonathan Isaac,1628371,2018-19,80,23,18,5,28,75,29,33,42,4036,16.37080868
Jarell Martin,1626185,2018-19,18,7,4,3,5,11,1,9,2,686,15.65789474
Troy Caupain,1628505,2018-19,4,1,1,0,3,0,0,0,0,32,21.62162162
Mo Bamba,1628964,2018-19,39,11,10,1,5,43,10,23,20,1540,18.0974478
Michael Carter-Williams,203487,2018-19,70,34,29,5,23,20,8,10,10,798,18.20151679
Nikola Vucevic,202696,2018-19,307,130,86,44,125,159,40,87,72,5108,28.1184669
Evan Fournier,203095,2018-19,295,111,77,34,93,154,67,58,96,5174,22.13438735
Amile Jefferson,1628518,2018-19,3,1,1,0,0,1,0,1,0,147,12.5748503
D.J. Augustin,201571,2018-19,426,142,105,37,162,128,65,42,86,4609,17.19474498
Markelle Fultz,1628365,2018-19,59,27,20,7,20,25,7,12,13,905,19.42800789
Jerian Grant,1626170,2018-19,156,54,43,11,42,51,26,20,31,1899,13.48946136
Khem Birch,203920,2018-19,38,12,9,3,11,20,7,11,9,1316,14.11290323
Wes Iwundu,1628411,2018-19,73,26,20,6,25,44,18,18,26,2531,12.84758888
Terrence Ross,203082,2018-19,135,44,29,15,55,90,46,32,58,4389,23.60097324
Melvin Frazier Jr.,1628982,2018-19,1,1,1,0,0,1,0,1,0,99,20.51282051
Mike Scott,203118,2018-19,66,19,14,5,36,44,15,25,19,2968,14.37125749
Amir Johnson,101161,2018-19,60,23,16,7,13,45,14,25,20,1120,17.43264659
Haywood Highsmith,1629312,2018-19,2,0,0,0,2,1,0,0,1,88,11.65048544
Zhaire Smith,1629015,2018-19,10,3,3,0,4,6,3,3,3,231,17.05426357
James Ennis III,203516,2018-19,41,14,10,4,19,34,9,20,14,2504,12.88386869
T.J. McConnell,204456,2018-19,258,99,78,21,116,91,42,29,62,3062,15.32187591
Jonathon Simmons,203613,2018-19,128,55,48,7,35,68,23,22,46,2189,18.78317681
JJ Redick,200755,2018-19,206,58,45,13,110,101,31,51,50,5075,21.51653765
Shake Milton,1629003,2018-19,18,3,3,0,10,6,0,4,2,564,15.02347418
Joel Embiid,203954,2018-19,234,94,79,15,58,226,51,118,108,4543,33.83133477
Jimmy Butler,202710,2018-19,263,106,72,34,94,95,34,45,50,4570,22.31643862
Ben Simmons,1627732,2018-19,610,260,215,45,240,274,118,108,166,5742,21.95535027
Furkan Korkmaz,1627788,2018-19,52,22,16,6,21,25,9,9,16,1440,17.97752809
Tobias Harris,202699,2018-19,229,90,66,24,89,151,46,65,86,5949,22.9618549
Jonah Bolden,1628413,2018-19,40,17,16,1,11,36,12,22,14,1364,13.54300385
Boban Marjanovic,1626246,2018-19,54,11,8,3,26,59,16,30,29,1430,22.92682927
Greg Monroe,202328,2018-19,24,6,3,3,13,32,2,19,13,1013,21.75408426
Devin Booker,1626164,2018-19,433,166,111,55,190,263,114,95,168,4697,32.66398929
Elie Okobo,1629059,2018-19,127,44,37,7,55,69,37,26,43,1962,17.30418944
Kelly Oubre Jr.,1626162,2018-19,84,28,23,5,31,103,29,39,64,4104,22.8154282
George King,1628994,2018-19,0,0,0,0,0,0,0,0,0,12,0
Jamal Crawford,2037,2018-19,229,43,30,13,140,99,52,32,67,2564,20.47299682
T.J. Warren,203933,2018-19,64,31,21,10,26,52,17,22,30,2838,22.60924636
De'Anthony Melton,1629001,2018-19,159,49,32,17,71,75,35,27,48,2055,14.99781373
Tyler Johnson,204020,2018-19,166,64,39,25,64,77,33,30,47,3142,18.53617499
Josh Jackson,1628367,2018-19,183,30,22,8,124,173,89,64,109,4138,24.02077472
Richaun Holmes,1626158,2018-19,60,23,20,3,19,52,8,39,13,2451,17.94214573
Deandre Ayton,1629028,2018-19,125,60,44,16,39,126,24,66,60,4514,21.4356731
Mikal Bridges,1628969,2018-19,173,47,31,16,89,70,33,26,44,5029,12.1706399
Ray Spalding,1629034,2018-19,5,3,3,0,1,8,4,2,6,313,16.90140845
Troy Daniels,203584,2018-19,26,7,5,2,14,27,12,13,14,1578,17.55681818
Jimmer Fredette,202690,2018-19,8,2,2,0,5,5,0,5,0,138,24.66666667
Dragan Bender,1627733,2018-19,56,26,22,4,20,37,13,15,22,1739,13.2505176
Enes Kanter,202683,2018-19,116,41,36,5,42,118,23,60,58,3356,22.47076767
Damian Lillard,203081,2018-19,551,165,120,45,296,212,113,72,140,5905,28.60495819
Evan Turner,202323,2018-19,283,130,111,19,113,114,65,30,84,3281,16.19379015
CJ McCollum,203468,2018-19,207,85,63,22,93,106,39,48,58,4934,25.18466409
Maurice Harkless,203090,2018-19,74,27,20,7,24,45,18,21,24,2945,13.70872642
Rodney Hood,203918,2018-19,126,50,40,10,53,55,17,26,29,3775,18.30398517
Al-Farouq Aminu,202329,2018-19,104,35,29,6,48,72,19,42,30,4744,13.63886343
Gary Trent Jr.,1629018,2018-19,5,1,0,1,2,4,0,2,2,240,21.59090909
Jake Layman,1627774,2018-19,53,26,19,7,18,46,15,24,22,2734,15.97822606
Meyers Leonard,203086,2018-19,75,31,26,5,25,42,11,23,19,1782,15.27363184
Skal Labissiere,1627746,2018-19,11,6,4,2,3,11,4,6,5,400,15.66820276
Anfernee Simons,1629014,2018-19,13,4,4,0,5,11,1,5,6,306,24.33234421
Jusuf Nurkic,203994,2018-19,233,62,52,10,123,168,53,81,87,4108,24.51912915
Seth Curry,203552,2018-19,66,29,23,6,23,60,26,27,33,2853,16.83594952
Zach Collins,1628380,2018-19,71,24,21,3,33,77,18,47,30,2750,17.1162492
Willie Cauley-Stein,1626161,2018-19,194,70,51,19,68,83,19,44,39,4750,17.55538866
Yogi Ferrell,1627812,2018-19,137,56,44,12,41,40,16,16,24,2237,16.5741475
De'Aaron Fox,1628368,2018-19,590,220,178,42,263,227,113,71,156,5520,24.25313203
Bogdan Bogdanovic,203992,2018-19,267,99,72,27,110,117,54,41,76,4092,22.582038
BJ Johnson,1629168,2018-19,0,0,0,0,0,2,0,2,0,104,18.91891892
Frank Mason,1628412,2018-19,84,28,26,2,31,36,16,18,18,946,21.85114504
Alec Burks,202692,2018-19,128,47,31,16,57,65,27,27,38,2780,19.11011524
Troy Williams,1627786,2018-19,11,4,2,2,1,9,2,6,3,690,14.69072165
Harry Giles III,1628385,2018-19,85,20,14,6,46,73,25,34,39,1755,23.51447435
Buddy Hield,1627741,2018-19,205,73,52,21,99,145,56,47,98,5623,24.81475642
Corey Brewer,201147,2018-19,39,12,10,2,16,19,8,8,11,1033,13.46633416
Marvin Bagley III,1628963,2018-19,62,22,16,6,26,98,17,58,40,3332,24.22734416
Harrison Barnes,203084,2018-19,115,57,47,10,44,98,33,41,57,5308,20.74396783
Kosta Koufos,201585,2018-19,36,22,15,7,3,27,8,15,12,1057,15.59934319
Caleb Swanigan,1628403,2018-19,11,5,4,1,3,18,3,10,8,377,17.36111111
Nemanja Bjelica,202357,2018-19,147,56,35,21,61,82,24,37,45,3831,16.62017666
Lonnie Walker IV,1629022,2018-19,9,2,1,1,5,4,1,1,3,248,20.29520295
Quincy Pondexter,202347,2018-19,24,6,5,1,8,13,6,6,7,611,13.20754717
Derrick White,1628401,2018-19,263,72,50,22,102,97,48,34,63,3455,18.21278826
Chimezie Metu,1629002,2018-19,13,5,3,2,4,15,4,6,9,314,22.68907563
Patty Mills,201988,2018-19,245,90,71,19,68,93,45,29,64,3969,18.09545352
DeMar DeRozan,201942,2018-19,475,196,142,54,120,199,72,66,133,5418,28.23549033
Bryn Forbes,1627854,2018-19,175,50,38,12,60,80,33,26,54,4610,17.60895171
LaMarcus Aldridge,200746,2018-19,194,71,56,15,45,144,17,84,60,5416,27.32276897
Drew Eubanks,1629234,2018-19,7,0,0,0,2,8,2,3,5,236,15.09433962
Marco Belinelli,201158,2018-19,132,57,38,19,41,72,28,27,45,3757,19.37724551
Rudy Gay,200752,2018-19,182,57,40,17,62,114,48,37,77,3737,22.14234364
Jakob Poeltl,1627751,2018-19,93,33,25,8,17,48,15,26,22,2585,12.91538198
Donatas Motiejunas,202700,2018-19,1,0,0,0,0,3,0,3,0,28,32.25806452
Dante Cunningham,201967,2018-19,50,13,12,1,17,22,12,6,16,1902,8.898305085
Davis Bertans,202722,2018-19,100,36,22,14,32,43,17,23,20,3360,13.94722671
Patrick McCaw,1627775,2018-19,29,20,16,4,7,17,7,6,11,816,9.592061742
Kawhi Leonard,202695,2018-19,199,103,61,42,68,121,34,49,72,4209,30.49327354
OG Anunoby,1628384,2018-19,47,19,11,8,18,55,16,26,29,2824,15.26117055
Kyle Lowry,200768,2018-19,564,154,94,60,244,182,106,55,127,4613,19.42823804
Jordan Loyd,1628070,2018-19,6,4,2,2,1,2,0,0,2,125,16.10738255
Serge Ibaka,201586,2018-19,99,59,41,18,26,114,12,80,34,4124,23.15675676
Malcolm Miller,1626259,2018-19,1,1,1,0,0,1,0,0,1,144,18.35443038
Danny Green,201980,2018-19,126,53,36,17,48,75,34,33,42,4582,14.18509098
Eric Moreland,203961,2018-19,4,2,2,0,1,5,4,1,4,87,12.37113402
Jeremy Lin,202391,2018-19,231,84,50,34,107,123,62,33,90,3085,21.94129613
Jodie Meeks,201975,2018-19,8,3,2,1,5,2,1,0,2,219,17.22689076
Fred VanVleet,1627832,2018-19,307,117,70,47,97,82,41,26,56,3591,18.15468789
Norman Powell,1626181,2018-19,91,37,24,13,31,65,27,25,40,2359,18.94576012
Chris Boucher,1628449,2018-19,2,1,1,0,0,7,2,4,3,353,22.24938875
Marc Gasol,201188,2018-19,349,142,98,44,133,155,48,67,88,4840,21.47042147
Pascal Siakam,1627783,2018-19,248,128,70,58,77,154,47,72,82,5269,20.91793209
Joe Ingles,204060,2018-19,469,125,80,45,263,193,100,64,129,5312,17.53008021
Ricky Rubio,201937,2018-19,416,147,93,54,215,180,91,64,116,3938,22.62361707
Dante Exum,203957,2018-19,110,40,27,13,57,52,23,19,33,1377,21.5483871
Tony Bradley,1628396,2018-19,1,1,1,0,0,3,0,3,0,79,21.05263158
Derrick Favors,202324,2018-19,89,44,26,18,36,85,27,44,41,3630,19.57156767
Thabo Sefolosha,200757,2018-19,27,16,13,3,11,25,7,13,12,1252,13.34776335
Royce O'Neale,1626220,2018-19,124,59,33,26,55,70,19,39,31,3459,11.09966521
Grayson Allen,1628960,2018-19,25,8,6,2,10,32,11,18,14,865,24.74012474
Raul Neto,203526,2018-19,93,45,28,17,37,35,19,10,25,997,19.0647482
Kyle Korver,2594,2018-19,81,26,16,10,45,59,29,23,36,2794,17.9853829
Rudy Gobert,203497,2018-19,161,71,53,18,55,129,27,69,60,5352,17.86069652
Naz Mitrou-Long,1628513,2018-19,15,5,2,3,9,8,3,3,5,178,14.4278607
Georges Niang,1627777,2018-19,35,11,8,3,19,23,10,12,11,1082,17.67634855
Ekpe Udoh,202327,2018-19,28,15,9,6,7,13,2,7,6,678,13.3243607
Tyler Cavanaugh,1628463,2018-19,1,0,0,0,0,1,0,1,0,88,12.24489796
Donovan Mitchell,1628378,2018-19,322,161,93,68,120,218,85,85,133,5403,31.55906029
Jae Crowder,203109,2018-19,133,62,42,20,56,85,37,38,47,4532,18.93746324
Trevor Ariza,2772,2018-19,252,87,58,29,115,106,51,42,64,4897,16.75605696
John Wall,202322,2018-19,279,101,68,33,122,121,59,36,85,2364,29.06213817
Bradley Beal,203078,2018-19,448,188,134,54,191,224,84,90,134,6401,28.22524163
Wesley Johnson,202325,2018-19,23,3,2,1,12,18,8,8,10,1132,11.86966641
Bobby Portis,1626171,2018-19,72,17,13,4,39,74,7,39,35,2698,24.75083056
Troy Brown Jr.,1628972,2018-19,80,23,19,4,39,30,12,7,23,1533,16.30309989
Devin Robinson,1628421,2018-19,6,3,3,0,2,2,1,0,2,196,17.77777778
Sam Dekker,1626155,2018-19,46,15,13,2,18,24,4,15,9,1626,16.33315306
Chasson Randle,1626184,2018-19,97,34,25,9,42,43,18,18,25,1549,16.6378814
Jabari Parker,203953,2018-19,152,65,41,24,67,151,48,73,78,3618,24.3762475
Thomas Bryant,1628418,2018-19,92,34,26,8,42,60,14,37,23,3143,17.55334282
Dwight Howard,2730,2018-19,4,0,0,0,2,16,1,12,4,483,19.59334566
Ian Mahinmi,101133,2018-19,25,8,6,2,12,21,5,14,7,1017,13.25823224
Tomas Satoransky,203107,2018-19,399,151,111,40,187,120,56,42,78,4514,14.27726287
Jeff Green,201145,2018-19,137,57,47,10,61,101,24,57,44,4388,17.8447749
Jordan McRae,203895,2018-19,30,9,7,2,19,15,3,8,7,719,19.94981179
Antonius Cleveland,1628499,2017-18,2,1,1,0,1,7,2,4,3,251,11.07142857
Tyler Dorsey,1628416,2017-18,79,32,22,10,18,37,17,11,26,1985,20.00897263
Jaylen Morris,1628537,2017-18,7,2,2,0,3,6,4,2,4,208,16.03375527
Andrew White III,1628510,2017-18,6,4,2,2,1,8,2,1,7,435,16.83778234
Malcolm Delaney,1627098,2017-18,163,68,35,33,49,66,26,33,33,2034,17.11908932
Jeremy Evans,202379,2017-18,0,0,0,0,0,1,0,1,0,12,14.28571429
Damion Lee,1627814,2017-18,29,13,12,1,11,14,4,5,9,841,18.83597884
Josh Magette,203705,2017-18,57,22,17,5,25,9,3,4,5,435,12.34309623
Taurean Prince,1627752,2017-18,214,76,33,43,94,192,71,74,118,5028,22.11144739
Dewayne Dedmon,203473,2017-18,90,43,34,9,24,84,23,49,35,3126,17.07949309
Dennis Schroder,203471,2017-18,417,170,115,55,153,183,91,61,122,4203,30.48264183
Miles Plumlee,203101,2017-18,45,15,11,4,10,63,13,36,27,1848,13.12108056
John Collins,1628381,2017-18,98,42,33,9,33,103,24,53,50,3621,17.87202746
Isaiah Taylor,1627819,2017-18,206,110,82,28,58,85,34,43,42,2388,20.2020202
Kent Bazemore,203145,2017-18,228,63,40,23,123,157,77,40,117,3602,22.73741632
Mike Muscala,203488,2017-18,51,28,21,7,14,42,11,20,22,2197,15.4158215
Tyler Cavanaugh,1628463,2017-18,27,15,12,3,4,13,2,10,3,1053,14.47587354
DeAndre' Bembry,1627761,2017-18,49,17,9,8,20,47,14,20,27,911,18.75616979
Jayson Tatum,1628369,2017-18,128,61,44,17,37,114,23,65,49,4837,19.78450678
Jaylen Brown,1627759,2017-18,114,40,24,16,38,124,35,56,68,4297,21.27174814
Shane Larkin,203499,2017-18,98,37,31,6,29,33,13,8,25,1509,15.84507042
Xavier Silas,202918,2017-18,0,0,0,0,0,0,0,0,0,15,15
Kyrie Irving,202681,2017-18,306,127,91,36,104,139,60,43,96,3900,30.45173125
Terry Rozier,1626179,2017-18,232,101,76,25,71,80,30,32,48,4107,20.52060738
Marcus Morris,202694,2017-18,72,30,19,11,27,65,15,39,26,2881,22.8844966
Gordon Hayward,202330,2017-18,0,0,0,0,0,0,0,0,0,11,15.38461538
Jabari Bird,1628444,2017-18,8,3,1,2,3,8,3,2,6,238,14.28571429
Daniel Theis,1628464,2017-18,56,29,24,5,15,56,17,32,24,1836,15.55343511
Abdel Nader,1627846,2017-18,26,11,7,4,8,34,13,14,20,1063,16.69449082
Guerschon Yabusele,1627824,2017-18,16,9,6,3,5,12,4,7,5,478,14.84794275
Marcus Smart,203935,2017-18,259,93,63,30,112,129,59,51,78,3247,19.31318681
Semi Ojeleye,1628400,2017-18,20,7,7,0,7,25,5,16,9,2260,9.105242412
Al Horford,201143,2017-18,339,146,103,43,117,131,52,61,70,4514,18.69756292
Kadeem Allen,1628443,2017-18,12,3,1,2,6,9,5,3,6,215,13.83399209
Aron Baynes,203382,2017-18,93,40,32,8,27,80,21,53,27,2897,17.08358755
Greg Monroe,202328,2017-18,114,38,30,8,55,94,29,30,64,2096,22.55067568
Jonathan Gibson,1626780,2017-18,4,1,0,1,2,3,1,1,2,85,28.26086957
James Webb III,1627821,2017-18,4,3,1,2,1,4,2,2,2,247,10.18181818
D'Angelo Russell,1626156,2017-18,249,97,78,19,122,146,61,49,97,2587,30.22530329
Nik Stauskas,203917,2017-18,39,17,10,7,13,26,6,13,13,1056,16.39624253
Jahlil Okafor,1626143,2017-18,12,9,8,1,2,21,4,13,8,690,22.5
Jeremy Lin,202391,2017-18,4,4,4,0,0,3,2,0,3,61,26.08695652
Spencer Dinwiddie,203915,2017-18,524,227,159,68,209,127,56,54,73,4637,20.6757535
DeMarre Carroll,201960,2017-18,147,68,50,18,50,102,24,49,53,4433,19.85205918
Joe Harris,203925,2017-18,128,55,40,15,51,91,33,45,46,4024,16.6261331
Quincy Acy,203112,2017-18,57,31,25,6,16,60,12,39,21,2767,14.77864583
Milton Doyle,1628495,2017-18,10,4,4,0,6,2,1,1,1,255,18.1184669
Isaiah Whitehead,1627785,2017-18,20,5,4,1,13,23,8,8,15,376,27.79097387
Timofey Mozgov,202389,2017-18,11,5,3,2,2,33,0,23,10,764,16.48873072
Caris LeVert,1627747,2017-18,299,118,86,32,131,153,64,55,98,3840,22.42100372
Rondae Hollis-Jefferson,1626178,2017-18,167,106,83,23,42,121,28,61,60,3938,22.26518081
Jarrett Allen,1628386,2017-18,49,24,18,6,16,82,21,41,41,2912,16.70229008
Allen Crabbe,203459,2017-18,117,43,32,11,53,78,30,34,44,4520,18.73397752
Dante Cunningham,201967,2017-18,48,28,22,6,17,33,11,17,16,3221,11.76966292
Malik Monk,1628370,2017-18,91,19,14,5,40,49,24,14,35,1774,24.73551637
Marvin Williams,101107,2017-18,96,29,25,4,38,66,27,30,36,4101,14.77469671
Jeremy Lamb,203087,2017-18,186,70,57,13,75,93,40,31,62,3969,22.52734985
Marcus Paige,1627779,2017-18,3,1,0,1,1,0,0,0,0,57,22.72727273
Nicolas Batum,201587,2017-18,349,107,96,11,150,131,79,42,89,4057,18.2457683
Dwayne Bacon,1628407,2017-18,38,23,19,4,12,23,12,6,17,1466,13.58695652
Mangok Mathiang,1628493,2017-18,0,0,0,0,0,0,0,0,0,43,14
Michael Carter-Williams,203487,2017-18,116,44,34,10,39,52,22,24,28,1646,17.10805085
Dwight Howard,2730,2017-18,105,40,34,6,33,208,21,148,60,5030,24.29099877
Michael Kidd-Gilchrist,203077,2017-18,71,34,27,7,19,53,9,24,29,3763,16.21939736
Kemba Walker,202689,2017-18,444,147,114,33,171,179,89,57,122,5579,27.24088521
Treveon Graham,1626203,2017-18,59,21,13,8,20,27,3,21,6,2119,11.51109251
Julyan Stone,202933,2017-18,26,10,8,2,11,7,3,4,3,371,5.185185185
Cody Zeller,203469,2017-18,31,13,11,2,8,33,9,20,13,1266,15.81881533
Willy Hernangomez,1626195,2017-18,33,15,11,4,7,35,8,22,13,1011,20.86956522
Frank Kaminsky,1626163,2017-18,129,50,34,16,45,66,22,31,35,3695,20.79422383
Sean Kilpatrick,203930,2017-18,46,24,14,10,13,38,14,14,24,1295,24.82900137
Jerian Grant,1626170,2017-18,342,140,106,34,106,89,44,30,59,3373,17.61288619
Omer Asik,201600,2017-18,3,0,0,0,0,9,4,4,5,368,9.25
Bobby Portis,1626171,2017-18,123,58,48,10,37,103,18,54,49,3342,25.68951931
Cristiano Felicio,1626245,2017-18,55,24,19,5,19,54,11,29,25,1964,13.632287
Justin Holiday,203200,2017-18,153,45,34,11,60,93,36,38,55,4674,18.04193114
Zach LaVine,203897,2017-18,72,25,17,8,28,43,12,22,21,1339,29.67180174
Antonio Blakeney,1628469,2017-18,20,9,7,2,8,11,3,5,6,632,23.48066298
David Nwaba,1628021,2017-18,104,38,32,6,46,77,23,40,37,3321,15.63655573
Ryan Arcidiacono,1627853,2017-18,35,15,13,2,17,13,5,5,8,617,8.248914616
Paul Zipser,1627835,2017-18,46,23,11,12,13,43,9,24,19,1610,16.1200667
Cameron Payne,1626166,2017-18,113,52,43,9,47,36,20,11,25,1189,18.80466472
Lauri Markkanen,1628374,2017-18,79,38,28,10,22,83,23,40,43,4108,21.96771379
Noah Vonleh,203943,2017-18,34,14,14,0,11,31,6,19,12,1754,14.51371571
Jarell Eddie,204067,2017-18,0,0,0,0,0,0,0,0,0,19,9.523809524
Kris Dunn,1627739,2017-18,310,120,93,27,106,150,63,59,91,3138,24.8924577
Robin Lopez,201577,2017-18,124,52,45,7,37,107,22,62,45,3435,20.68604347
Denzel Valentine,1627756,2017-18,244,93,68,25,101,99,38,45,54,4254,17.47188671
Kevin Love,201567,2017-18,103,36,24,12,56,89,32,40,49,3337,25.29826464
Rodney Hood,203918,2017-18,95,45,22,23,36,70,20,31,39,3220,24.68229314
George Hill,201588,2017-18,186,74,55,19,57,88,32,43,45,3563,16.49638674
JR Smith,2747,2017-18,141,63,35,28,61,81,41,26,55,4537,13.88118812
Jordan Clarkson,203903,2017-18,221,77,63,14,108,127,41,53,74,3875,26.14720582
Tristan Thompson,202684,2017-18,33,11,8,3,9,36,5,24,12,2169,12.38327243
Okaro White,1627855,2017-18,2,1,1,0,0,1,1,0,1,160,10.34482759
Cedi Osman,1626224,2017-18,41,18,12,6,17,32,7,17,15,1368,15.48471047
Kendrick Perkins,2570,2017-18,2,0,0,0,2,1,1,0,1,28,11.76470588
Larry Nance Jr.,1626204,2017-18,82,32,25,7,33,51,15,29,22,2909,15.93806922
LeBron James,2544,2017-18,747,344,214,130,285,348,153,135,213,6157,31.48773682
Kyle Korver,2594,2017-18,88,20,13,7,54,54,18,30,24,3247,15.76285473
Jeff Green,201145,2017-18,99,44,37,7,40,75,12,41,34,3713,19.47226973
Ante Zizic,1627790,2017-18,5,2,1,1,1,11,2,6,5,441,17.82178218
Jose Calderon,101181,2017-18,117,44,31,13,55,41,24,13,28,1825,12.04637097
Dennis Smith Jr.,1628372,2017-18,358,175,123,52,104,194,75,70,124,4097,28.81767956
Nerlens Noel,203457,2017-18,20,6,5,1,7,26,9,12,14,947,13.51606805
J.J. Barea,200826,2017-18,434,127,101,26,194,143,81,40,103,3177,25.1435132
Johnathan Motley,1628405,2017-18,7,2,2,0,3,9,1,5,4,342,24.43324937
Dwight Powell,203939,2017-18,91,43,39,4,31,59,13,35,24,3300,15.61899533
Kyle Collinsworth,1627858,2017-18,56,20,14,6,23,24,13,6,18,943,12.9476584
Aaron Harrison,1626151,2017-18,11,7,6,1,2,3,1,2,1,467,15.18026565
Dorian Finney-Smith,1627827,2017-18,26,14,9,5,6,21,10,9,12,888,14.79642502
Yogi Ferrell,1627812,2017-18,201,90,65,25,58,78,39,31,47,4500,17.14572864
Doug McDermott,203926,2017-18,79,31,24,7,22,56,13,32,24,3563,14.85173187
Jalen Jones,1627883,2017-18,4,2,1,1,2,7,1,5,2,357,19.80906921
Wesley Matthews,202083,2017-18,172,85,69,16,57,83,40,25,58,4214,17.81236489
Harrison Barnes,203084,2017-18,152,87,64,23,38,118,41,42,76,5225,25.37417334
Dirk Nowitzki,1717,2017-18,120,43,28,15,48,51,17,20,31,3793,20.66115702
Maxi Kleber,1628467,2017-18,51,31,26,5,8,30,16,9,21,2379,13.82575758
Salah Mejri,1626257,2017-18,35,19,16,3,5,38,6,23,15,1416,12.94191919
Darrell Arthur,201589,2017-18,9,5,5,0,4,15,1,11,4,294,20
Torrey Craig,1628470,2017-18,25,9,8,1,10,20,6,8,12,1235,12.5
Paul Millsap,200794,2017-18,105,50,39,11,36,73,18,37,36,2282,22.30354391
Will Barton,203115,2017-18,331,120,94,26,151,149,46,67,82,5398,20.65605716
Trey Lyles,1626168,2017-18,91,39,35,4,37,61,25,21,40,2785,21.29337539
Monte Morris,1628420,2017-18,7,1,1,0,4,1,1,0,1,53,14.03508772
Gary Harris,203914,2017-18,194,81,67,14,77,119,43,49,70,4630,20.88414634
Nikola Jokic,203999,2017-18,458,146,116,30,221,208,66,102,106,4872,24.30293218
Tyler Lydon,1628399,2017-18,0,0,0,0,0,0,0,0,0,4,0
Wilson Chandler,201163,2017-18,159,83,50,33,47,92,28,36,56,4689,14.51098179
Richard Jefferson,2210,2017-18,15,9,6,3,6,5,3,2,3,330,9.333333333
Mason Plumlee,203486,2017-18,142,52,36,16,69,101,35,45,56,2881,16.68700427
Malik Beasley,1627736,2017-18,31,17,13,4,13,24,10,10,14,1200,15.7779401
Jamal Murray,1627750,2017-18,274,105,88,17,91,172,67,64,108,5118,22.96923609
Devin Harris,2734,2017-18,152,53,41,12,63,76,39,28,48,2690,20.24250589
Kenneth Faried,202702,2017-18,18,6,5,1,7,23,5,15,8,916,17.92279412
Juancho Hernangomez,1627823,2017-18,12,7,3,4,4,9,2,5,4,557,13.77708978
Andre Drummond,203083,2017-18,237,52,40,12,94,199,59,97,102,5258,21.05878424
Reggie Jackson,202704,2017-18,238,106,74,32,88,99,41,32,67,2371,27.05795496
Luke Kennard,1628379,2017-18,124,56,38,18,45,69,24,26,43,2883,17.43573862
Stanley Johnson,1626169,2017-18,112,53,38,15,48,77,32,31,46,3768,16.54135338
Henry Ellenson,1627740,2017-18,20,14,11,3,4,18,9,7,11,666,23.95128552
Langston Galloway,204038,2017-18,58,28,23,5,19,18,6,8,10,1711,19.44734098
Ish Smith,202397,2017-18,360,189,140,49,116,107,42,39,68,4098,20.78541983
Dwight Buycks,202779,2017-18,59,26,17,9,16,39,22,12,27,837,27.51605996
Kay Felder,1627770,2017-18,20,7,4,3,9,16,10,5,11,285,28.93081761
Blake Griffin,201933,2017-18,334,141,111,30,114,165,65,69,96,3970,29.01577427
Eric Moreland,203961,2017-18,78,30,26,4,21,41,15,22,19,1549,10.06904488
Reggie Bullock,203493,2017-18,95,39,27,12,35,47,18,18,29,3488,15.60517635
Jon Leuer,202720,2017-18,5,0,0,0,2,7,1,5,2,288,15.75562701
James Ennis III,203516,2017-18,71,20,13,7,35,56,24,25,31,3132,13.8700565
Reggie Hearn,203687,2017-18,0,0,0,0,0,0,0,0,0,13,11.11111111
Jameer Nelson,2749,2017-18,179,75,54,21,66,67,35,21,46,2047,14.2412105
Anthony Tolliver,201229,2017-18,90,25,18,7,39,58,24,24,34,3485,14.88764045
Patrick McCaw,1627775,2017-18,81,32,25,7,23,41,14,17,24,1956,12.89728236
JaVale McGee,201580,2017-18,33,11,9,2,9,27,9,13,14,1282,18.85995778
Jordan Bell,1628395,2017-18,102,26,24,2,40,51,22,21,30,1661,13.93442623
David West,2561,2017-18,138,31,21,10,64,80,30,42,38,1960,22.80945758
Quinn Cook,1626188,2017-18,89,29,24,5,28,32,13,13,19,1489,18.07598039
Kevon Looney,1626172,2017-18,42,16,13,3,15,31,8,15,16,1854,12.54237288
Nick Young,201156,2017-18,36,15,11,4,9,39,15,17,22,2868,17.5
Andre Iguodala,2738,2017-18,210,65,54,11,81,67,26,25,42,3321,11.62472648
Klay Thompson,202691,2017-18,185,42,30,12,105,128,53,51,77,5167,23.79523389
Damian Jones,1627745,2017-18,2,0,0,0,2,4,0,3,1,177,14.89361702
Draymond Green,203110,2017-18,508,149,116,33,203,202,102,81,121,4752,17.33513305
Zaza Pachulia,2585,2017-18,109,46,39,7,34,72,27,37,35,2013,16.93620845
Stephen Curry,201939,2017-18,310,93,72,21,152,153,74,55,98,3507,29.67977089
Shaun Livingston,2733,2017-18,140,43,35,8,47,58,22,29,29,2265,17.11857548
Kevin Durant,201142,2017-18,366,131,104,27,166,207,88,78,129,4862,29.99062793
Trevor Ariza,2772,2017-18,105,59,29,30,39,52,14,27,25,4596,14.34689507
RJ Hunter,1626154,2017-18,3,1,0,1,2,2,1,1,1,90,21.78217822
Chris Paul,101108,2017-18,457,264,195,69,163,128,54,45,83,3688,24.90215264
PJ Tucker,200782,2017-18,77,36,25,11,36,74,24,44,30,4589,10.55912722
Aaron Jackson,1628935,2017-18,1,1,0,1,0,1,0,1,0,65,15.27777778
Joe Johnson,2207,2017-18,83,44,24,20,32,49,14,15,34,2402,16.16314199
Zhou Qi,1627753,2017-18,2,1,0,1,1,10,1,5,5,262,16.38225256
Eric Gordon,201569,2017-18,154,76,38,38,64,130,37,59,71,4390,24.36444987
Luc Mbah a Moute,201601,2017-18,55,29,15,14,20,68,18,38,30,3140,13.15028902
James Harden,201935,2017-18,630,241,165,76,359,314,149,100,214,5133,35.98040931
Gerald Green,101123,2017-18,25,12,8,4,11,31,8,15,16,1886,22.5060241
Clint Capela,203991,2017-18,68,38,19,19,25,102,21,56,46,4057,19.48222905
Chinanu Onuaku,1627778,2017-18,1,0,0,0,1,3,1,2,1,39,18.60465116
Markel Brown,203900,2017-18,2,0,0,0,2,2,2,0,2,62,13.63636364
Tarik Black,204028,2017-18,13,6,5,1,4,35,9,22,13,1106,15.17352704
Ryan Anderson,201583,2017-18,60,35,27,8,22,42,8,20,22,3502,14.41717791
Nene ,2403,2017-18,45,28,20,8,16,40,11,23,17,1568,18.85913853
Alex Poythress,1627816,2017-18,2,1,1,0,0,2,1,1,1,205,11.76470588
Lance Stephenson,202362,2017-18,235,51,37,14,110,131,66,48,83,3647,21.6457529
Darren Collison,201954,2017-18,368,111,88,23,118,86,36,36,50,4031,17.47767857
Joe Young,1626202,2017-18,39,13,7,6,16,26,6,12,14,1109,17.76367962
Victor Oladipo,203506,2017-18,323,105,72,33,140,220,68,88,132,5126,30.10320098
Edmond Sumner,1628410,2017-18,0,0,0,0,0,0,0,0,0,4,25
Cory Joseph,202709,2017-18,260,90,67,23,84,87,40,31,56,4366,14.76401775
Domantas Sabonis,1627734,2017-18,151,69,49,20,37,137,29,80,57,3587,22.01722017
Ike Anigbogu,1628387,2017-18,0,0,0,0,0,2,1,0,2,64,18.42105263
Trevor Booker,202344,2017-18,82,46,37,9,18,59,11,34,25,2360,16.48638568
Thaddeus Young,201152,2017-18,152,63,38,25,59,103,43,40,63,5154,17.49089016
TJ Leaf,1628388,2017-18,9,4,3,1,1,11,7,3,8,928,14.39322672
Al Jefferson,2744,2017-18,30,8,4,4,9,21,7,9,12,955,22.67168391
Ben Moore,1628500,2017-18,1,0,0,0,1,0,0,0,0,20,0
Myles Turner,1626167,2017-18,87,38,20,18,34,96,21,61,35,3661,20.29411765
Glenn Robinson III,203922,2017-18,17,3,3,0,8,5,0,4,1,668,12.38591917
Bojan Bogdanovic,202711,2017-18,119,40,27,13,47,106,35,46,60,4917,19.00675552
Sindarius Thornwell,1628414,2017-18,68,13,11,2,43,53,19,23,30,2340,12.25416036
Jawun Evans,1628393,2017-18,100,24,16,8,56,44,24,11,33,1611,17.65356945
Milos Teodosic,1628462,2017-18,209,61,45,16,117,97,48,36,61,2364,18.23372668
Montrezl Harrell,1626149,2017-18,74,22,16,6,30,68,20,26,42,2656,23.61389446
DeAndre Jordan,201599,2017-18,117,36,26,10,46,137,47,69,68,4896,15.30758226
Sam Dekker,1626155,2017-18,38,8,5,3,23,33,13,17,16,1815,15.47851563
Danilo Gallinari,201568,2017-18,41,12,7,5,21,26,10,12,14,1337,21.04918033
C.J. Williams,203710,2017-18,43,11,8,3,20,20,4,13,7,1433,13.78676471
Avery Bradley,202340,2017-18,94,38,29,9,38,101,38,45,56,2867,23.3241506
Tyrone Wallace,1627820,2017-18,71,17,11,6,41,46,17,15,31,1786,16.38530288
Patrick Beverley,201976,2017-18,32,9,6,3,12,25,14,9,16,648,20.07926024
Lou Williams,101150,2017-18,417,95,61,34,264,234,139,64,170,5404,29.11413132
Austin Rivers,203085,2017-18,242,103,77,26,97,109,35,45,64,4109,20.99871959
Wesley Johnson,202325,2017-18,61,25,19,6,31,53,25,23,30,3053,13.00931315
Tobias Harris,202699,2017-18,192,89,59,30,76,105,34,51,54,5383,23.14117262
Boban Marjanovic,1626246,2017-18,22,3,2,1,13,36,4,23,13,697,28.75157629
Kyle Kuzma,1628398,2017-18,141,49,36,13,79,139,32,75,64,4960,22.47510669
Kentavious Caldwell-Pope,203484,2017-18,162,54,43,11,83,97,32,42,55,5098,16.84338606
Lonzo Ball,1628366,2017-18,376,118,88,30,180,136,68,53,83,3753,17.24952741
Isaiah Thomas,202738,2017-18,153,54,37,17,77,95,34,37,58,1820,28.26193993
Alex Caruso,1627936,2017-18,75,25,21,4,40,42,21,13,29,1157,13.3126935
Josh Hart,1628404,2017-18,80,36,29,7,32,47,25,15,32,2974,13.76554174
Luol Deng,2736,2017-18,1,0,0,0,0,1,0,1,0,29,9.090909091
Tyler Ennis,203898,2017-18,105,39,29,10,39,37,19,14,23,1399,17.46335245
Brook Lopez,201572,2017-18,126,36,27,9,55,98,27,55,43,3627,23.49471615
Channing Frye,101112,2017-18,38,20,15,5,16,21,7,11,10,1418,15.46391753
Brandon Ingram,1627742,2017-18,230,99,75,24,97,150,49,58,92,4098,22.17940484
Andre Ingram,201281,2017-18,7,4,3,1,1,3,1,2,1,141,13.90728477
Travis Wear,204037,2017-18,7,5,5,0,1,6,3,1,5,457,16.17357002
Gary Payton II,1627780,2017-18,21,9,7,2,5,7,2,5,2,447,16.6015625
Julius Randle,203944,2017-18,210,99,77,22,76,213,42,114,99,4511,25.65063091
Thomas Bryant,1628418,2017-18,6,2,1,1,3,2,0,2,0,151,16.26506024
Ivica Zubac,1627826,2017-18,25,8,8,0,7,26,7,8,18,844,17.87941788
JaMychal Green,203210,2017-18,79,22,18,4,36,76,25,38,38,2988,18.21958457
Jarell Martin,1626185,2017-18,73,27,20,7,26,86,30,33,53,3261,17.31919521
Kobi Simmons,1628424,2017-18,68,25,18,7,25,44,20,21,23,1273,16.90921691
Briante Weber,1627362,2017-18,22,12,9,3,7,15,8,4,11,485,11.47540984
Myke Henry,1627988,2017-18,22,7,4,3,7,19,11,5,14,761,15.22491349
Andrew Harrison,1626150,2017-18,177,61,47,14,57,81,41,32,49,2542,20.18156425
Mario Chalmers,201596,2017-18,197,60,52,8,102,117,46,52,65,2868,19.22600619
Wayne Selden,1627782,2017-18,66,15,11,4,33,54,22,22,32,1401,22.24346718
MarShon Brooks,202705,2017-18,25,9,3,6,11,16,6,8,8,384,28.22222222
Ivan Rabb,1628397,2017-18,32,7,6,1,16,35,16,8,27,1025,17.23259762
Mike Conley,201144,2017-18,49,22,16,6,17,18,10,2,16,720,26.86945501
Tyreke Evans,201936,2017-18,269,92,69,23,124,117,54,47,70,3127,28.56739192
Marquis Teague,203104,2017-18,13,5,5,0,1,3,1,2,1,148,12.5748503
Deyonta Davis,1627738,2017-18,40,20,18,2,10,32,7,19,13,1879,15.19285042
Ben McLemore,203463,2017-18,51,17,14,3,15,61,28,24,37,2159,18.76523152
Dillon Brooks,1628415,2017-18,135,43,32,11,50,124,46,62,62,4580,18.84510339
Chandler Parsons,202718,2017-18,69,22,19,3,33,35,10,18,17,1370,18.61702128
Marc Gasol,201188,2017-18,305,131,98,33,126,194,53,95,99,4677,26.09360076
Josh Richardson,1626196,2017-18,231,88,62,26,96,140,55,56,84,5307,18.17114094
Wayne Ellington,201961,2017-18,79,30,18,12,36,52,21,22,30,3991,17.33183857
Dwyane Wade,2548,2017-18,228,84,60,24,110,140,63,50,90,3138,25.7981756
Derrick Jones Jr.,1627884,2017-18,9,4,1,3,3,7,4,3,4,483,12.70125224
Goran Dragic,201609,2017-18,359,127,75,52,155,166,62,75,91,4746,25.44534033
Tyler Johnson,204020,2017-18,165,80,56,24,59,81,39,30,51,4067,18.5347664
Kelly Olynyk,203482,2017-18,207,105,72,33,72,147,42,73,74,3503,22.0709147
Dion Waiters,203079,2017-18,113,58,39,19,40,70,29,26,44,1813,25.54780876
Bam Adebayo,1628389,2017-18,101,58,44,14,19,66,10,38,28,2637,16.34097035
Derrick Walton Jr.,1628476,2017-18,16,7,6,1,4,2,1,1,1,285,9.677419355
James Johnson,201949,2017-18,280,146,109,37,101,141,44,70,71,3854,19.05756732
Rodney McGruder,203585,2017-18,17,8,6,2,6,3,0,2,1,588,11.816839
Justise Winslow,1626159,2017-18,148,55,37,18,66,77,31,32,45,3317,16.37144391
Hassan Whiteside,202355,2017-18,54,22,20,2,14,92,21,43,49,2730,23.97679665
Luke Babbitt,202337,2017-18,31,18,11,7,7,19,7,12,7,1451,15.2173913
Jordan Mickey,1626175,2017-18,9,4,4,0,1,18,5,12,6,551,17.47572816
Udonis Haslem,2617,2017-18,5,2,2,0,1,2,0,1,1,136,11.68831169
Xavier Munford,204098,2017-18,4,1,1,0,1,2,0,1,1,42,18.75
Jason Terry,1891,2017-18,59,18,11,7,26,25,13,10,15,1631,10.03861004
D.J. Wilson,1628391,2017-18,3,0,0,0,2,4,1,2,2,144,13.37579618
Eric Bledsoe,202339,2017-18,370,100,64,36,183,218,90,90,128,4680,25.93092803
Thon Maker,1627748,2017-18,46,12,8,4,28,44,16,20,24,2428,15.1014275
Matthew Dellavedova,203521,2017-18,145,41,28,13,77,49,28,17,32,1394,13.79763469
Brandon Jennings,201943,2017-18,44,5,3,2,24,18,10,7,11,420,19.62025316
Jabari Parker,203953,2017-18,59,15,11,4,30,45,12,21,24,1504,23.57771261
Malcolm Brogdon,1627763,2017-18,152,44,33,11,61,66,28,28,38,2844,19.30329179
Shabazz Muhammad,203498,2017-18,14,6,6,0,4,6,0,4,2,835,23.1511254
Tony Snell,203503,2017-18,98,34,27,7,36,36,16,14,22,4104,10.72142064
Khris Middleton,203114,2017-18,328,102,64,38,174,191,77,74,117,5983,24.28289574
Sterling Brown,1628425,2017-18,25,14,9,5,8,25,7,11,14,1533,13.93869289
John Henson,203089,2017-18,114,33,22,11,45,84,19,57,27,3912,15.15570934
Giannis Antetokounmpo,203507,2017-18,361,172,113,59,122,223,48,117,106,5489,31.39419908
Marshall Plumlee,1627850,2017-18,2,1,0,1,0,3,0,1,2,108,11.66666667
Tyler Zeller,203092,2017-18,47,24,19,5,14,47,7,26,21,2266,16.10764431
Jeff Teague,201952,2017-18,492,117,77,40,212,177,92,50,127,4654,20.42867982
Tyus Jones,1626145,2017-18,232,81,55,26,82,59,24,27,32,2884,12.93394777
Anthony Brown,1626148,2017-18,1,0,0,0,1,0,0,0,0,9,11.11111111
Gorgui Dieng,203476,2017-18,71,33,26,7,22,59,11,37,22,2668,16.52754591
Nemanja Bjelica,202357,2017-18,86,23,13,10,35,52,14,22,30,2768,14.32720232
Jamal Crawford,2037,2017-18,185,38,32,6,102,95,45,36,59,3298,23.83799946
Marcus Georges-Hunt,1627875,2017-18,7,4,2,2,2,3,0,2,1,456,11.77606178
Andrew Wiggins,203952,2017-18,160,61,38,23,56,138,38,54,84,5959,23.28362616
Jimmy Butler,202710,2017-18,288,74,52,22,118,109,43,48,61,4252,25.01554404
Justin Patton,1628383,2017-18,0,0,0,0,0,0,0,0,0,9,22.22222222
Derrick Rose,201565,2017-18,37,13,8,5,14,35,9,13,22,877,25.10330579
Aaron Brooks,201166,2017-18,20,8,7,1,4,11,5,5,6,382,19.90632319
Karl-Anthony Towns,1626157,2017-18,199,58,40,18,81,159,29,103,56,5760,22.9969419
Cole Aldrich,202332,2017-18,3,1,0,1,1,1,0,1,0,108,15.2
Taj Gibson,201959,2017-18,99,39,30,9,35,89,16,43,46,5423,14.72931231
DeMarcus Cousins,202326,2017-18,257,84,42,42,111,243,77,113,130,3565,32.53503185
Larry Drew II,203580,2017-18,10,3,1,2,4,3,2,1,2,139,17.41935484
Ian Clark,203546,2017-18,110,35,29,6,55,57,27,21,36,3005,17.30187538
Nikola Mirotic,202703,2017-18,80,21,17,4,35,62,22,26,36,3121,23.03949628
Charles Cooke,1628429,2017-18,1,1,1,0,0,1,0,1,0,83,16.49484536
Rajon Rondo,200765,2017-18,533,143,108,35,248,150,74,66,84,3602,16.69176707
Jrue Holiday,201950,2017-18,486,168,119,49,208,213,99,79,134,6133,22.9428276
Cheick Diallo,1627767,2017-18,19,7,6,1,7,28,5,18,10,1202,17.35228123
Darius Miller,203121,2017-18,111,39,28,11,46,58,25,20,38,4023,12.77364026
Anthony Davis,203076,2017-18,174,75,52,23,59,162,32,78,84,5723,29.73229843
Jordan Crawford,202348,2017-18,13,7,5,2,4,5,0,2,3,116,24.06015038
DeAndre Liggins,202732,2017-18,48,18,13,5,20,20,9,8,12,1436,8.15806246
Solomon Hill,203524,2017-18,22,9,5,4,7,9,2,6,3,407,11.67400881
Emeka Okafor,2731,2017-18,8,6,6,0,0,13,3,8,5,758,13.6682243
E'Twaun Moore,202734,2017-18,187,56,40,16,80,102,31,44,58,5413,16.13498993
Enes Kanter,202683,2017-18,105,31,29,2,30,121,26,64,57,3662,21.604354
Troy Williams,1627786,2017-18,16,5,4,1,5,19,10,8,11,638,19.41747573
Emmanuel Mudiay,1626144,2017-18,206,73,50,23,81,113,45,52,61,2555,23.76712329
Luke Kornet,1628436,2017-18,26,8,8,0,11,12,5,2,10,667,19.23601637
Tim Hardaway Jr.,203501,2017-18,155,57,38,19,52,92,38,36,56,3826,23.41931066
Isaiah Hicks,1628439,2017-18,16,10,8,2,1,16,4,10,6,484,18.23308271
Courtney Lee,201584,2017-18,180,53,44,9,68,84,37,34,50,4624,16.91134414
Kristaps Porzingis,204001,2017-18,57,26,20,6,14,92,12,48,44,3102,31.08031674
Michael Beasley,201563,2017-18,123,39,23,16,52,143,48,53,90,3335,26.69123454
Kyle O'Quinn,203124,2017-18,158,24,19,5,95,100,30,62,38,2762,17.42081448
Frank Ntilikina,1628373,2017-18,250,83,70,13,100,131,80,31,100,3404,17.16359865
Joakim Noah,201149,2017-18,4,2,2,0,1,4,1,3,1,84,17.0212766
Damyean Dotson,1628422,2017-18,31,10,9,1,16,17,8,6,11,958,17.36694678
Trey Burke,203504,2017-18,170,54,37,17,77,43,17,19,24,1581,25.38071066
Ron Baker,1627758,2017-18,47,10,8,2,27,18,9,7,11,768,10.41666667
Lance Thomas,202498,2017-18,44,15,10,5,12,41,11,23,18,2683,10.97199341
Jarrett Jack,101127,2017-18,348,98,64,34,142,115,53,35,80,3100,16.78977273
Russell Westbrook,201566,2017-18,820,310,224,86,371,382,193,119,263,5946,33.21814255
Raymond Felton,101109,2017-18,203,87,59,28,84,76,32,25,51,2628,21.77283451
Corey Brewer,201147,2017-18,65,21,18,3,33,49,20,23,26,2528,14.1025641
Nick Collison,2555,2017-18,4,1,1,0,1,7,0,7,0,152,18.71345029
Carmelo Anthony,2546,2017-18,103,56,35,21,33,98,23,57,41,5068,22.6798924
Alex Abrines,203518,2017-18,28,10,7,3,11,25,10,8,17,2256,12.97297297
Jerami Grant,203924,2017-18,57,39,26,13,13,54,11,23,31,3263,16.6711846
Steven Adams,203500,2017-18,88,37,26,11,32,128,19,78,50,5032,16.27398182
Paul George,202331,2017-18,263,100,60,40,112,212,82,90,122,5867,25.41697417
Kyle Singler,202713,2017-18,2,2,1,1,0,3,0,1,2,119,22.22222222
Andre Roberson,203460,2017-18,46,15,10,5,19,30,8,18,12,2025,8.753647353
Terrance Ferguson,1628390,2017-18,19,8,5,3,7,11,2,8,3,1509,10.59564719
Daniel Hamilton,1627772,2017-18,8,1,1,0,5,2,0,2,0,55,20.96774194
Josh Huestis,203962,2017-18,20,12,9,3,5,26,12,9,17,1917,9.805693629
PJ Dozier,1628408,2017-18,0,0,0,0,0,1,0,1,0,6,42.85714286
Dakari Johnson,1626177,2017-18,8,5,3,2,2,3,0,3,0,319,14.24657534
Patrick Patterson,202335,2017-18,57,37,30,7,15,33,11,18,15,2462,11.63465024
Aaron Gordon,203932,2017-18,136,40,29,11,70,107,29,56,51,3943,24.19281492
Jamel Artis,1628503,2017-18,18,11,8,3,5,8,2,3,5,553,14.44270016
Jonathan Isaac,1628371,2017-18,18,8,6,2,3,27,7,11,16,1074,15.53480475
Arron Afflalo,201167,2017-18,30,16,11,5,9,21,7,11,10,1347,13.11365165
Marreese Speights,201578,2017-18,40,13,9,4,20,40,9,23,17,1358,27.47179827
Mario Hezonja,1626209,2017-18,106,29,23,6,57,86,27,37,49,3344,20.0750469
Nikola Vucevic,202696,2017-18,191,74,59,15,83,109,45,45,64,3500,25.74850299
Evan Fournier,203095,2017-18,165,62,39,23,66,95,31,39,56,3824,23.0495613
Bismack Biyombo,202687,2017-18,66,16,13,3,23,84,17,51,33,2964,15.03267974
D.J. Augustin,201571,2017-18,287,92,65,27,107,123,53,47,76,3582,18.62622211
Rodney Purvis,1628681,2017-18,17,6,4,2,9,10,2,7,3,577,18.98148148
Jonathon Simmons,203613,2017-18,171,88,71,17,45,145,42,53,92,4130,21.98209998
Khem Birch,203920,2017-18,34,14,14,0,8,21,2,17,4,1144,13.38403042
Wes Iwundu,1628411,2017-18,57,24,22,2,23,30,15,11,19,2016,11.79307321
Terrence Ross,203082,2017-18,38,13,10,3,15,29,13,14,15,1250,17.09090909
Jerryd Bayless,201573,2017-18,54,20,16,4,15,46,13,23,23,1925,15.06660542
Justin Anderson,1626147,2017-18,25,8,7,1,13,16,6,9,7,1052,19.69823973
Amir Johnson,101161,2017-18,118,33,31,2,44,56,16,31,25,2419,12.91848617
Timothe Luwawu-Cabarrot,1627789,2017-18,54,14,11,3,29,38,11,20,18,1675,17.37532808
Dario Saric,203967,2017-18,202,72,62,10,91,148,52,65,83,4749,20.90909091
Demetrius Jackson,1627743,2017-18,9,3,3,0,3,10,4,4,6,163,15.84699454
T.J. McConnell,204456,2017-18,303,121,92,29,130,112,53,49,63,3526,13.83299799
JJ Redick,200755,2017-18,210,74,64,10,106,103,42,42,61,4413,21.30487314
Marco Belinelli,201158,2017-18,148,54,32,22,51,94,40,36,58,3990,20.3662842
Markelle Fultz,1628365,2017-18,53,23,16,7,20,17,3,8,9,543,22.54901961
Joel Embiid,203954,2017-18,199,73,55,18,71,231,51,112,119,3904,34.16134913
Richaun Holmes,1626158,2017-18,61,21,20,1,18,25,7,14,11,1546,16.42897889
Ersan Ilyasova,101141,2017-18,90,32,19,13,28,72,22,38,34,3511,18.85598583
Ben Simmons,1627732,2017-18,661,302,256,46,250,278,115,124,154,5665,22.35404308
Furkan Korkmaz,1627788,2017-18,4,0,0,0,4,2,0,1,1,174,16.24365482
Robert Covington,203496,2017-18,156,55,41,14,73,126,45,62,64,5219,17.24488069
Marquese Chriss,1627737,2017-18,83,27,21,6,22,107,32,59,48,3169,18.17930271
Devin Booker,1626164,2017-18,253,88,59,29,133,194,76,76,118,3948,30.83966056
Elfrid Payton,203901,2017-18,393,147,116,31,159,168,71,63,105,3739,21.5835917
Jared Dudley,201162,2017-18,78,26,19,7,37,28,16,10,18,1407,10.52631579
Tyson Chandler,2199,2017-18,53,8,7,1,17,59,24,31,28,2357,10.80178174
Tyler Ulis,1627755,2017-18,311,115,87,28,157,127,75,36,91,3395,18.83606131
Shaquille Harrison,1627885,2017-18,55,24,20,4,22,22,11,8,14,806,18.02002225
T.J. Warren,203933,2017-18,85,38,30,8,28,85,23,48,37,4440,24.83660131
Alan Williams,1626210,2017-18,8,7,4,3,1,7,3,4,3,141,18.58974359
Josh Jackson,1628367,2017-18,119,44,20,24,64,146,49,59,87,4083,26.06624811
Alex Len,203458,2017-18,82,32,22,10,25,79,25,43,36,2919,16.91934506
Danuel House Jr.,1627863,2017-18,25,11,10,1,11,11,4,6,5,820,16.59388646
Alec Peters,1628409,2017-18,12,5,4,1,5,4,3,0,4,467,15.51724138
Troy Daniels,203584,2017-18,48,15,11,4,19,56,20,26,30,3335,17.4282678
Davon Reed,1628432,2017-18,13,5,5,0,6,10,2,4,6,506,16.25441696
Dragan Bender,1627733,2017-18,130,39,30,9,47,112,45,52,60,4290,12.8716989
Damian Lillard,203081,2017-18,481,148,108,40,219,206,102,61,145,5416,29.92831541
Evan Turner,202323,2017-18,173,66,55,11,66,98,32,37,61,4074,15.64596408
Wade Baldwin IV,1627735,2017-18,5,1,1,0,2,4,0,4,0,163,16.20111732
CJ McCollum,203468,2017-18,272,105,73,32,108,151,52,56,95,5860,26.48697485
Maurice Harkless,203090,2017-18,53,25,18,7,16,40,9,24,16,2530,12.70506108
Pat Connaughton,1626192,2017-18,91,43,33,10,22,43,17,22,21,2979,13.28424153
Shabazz Napier,203894,2017-18,150,66,51,15,56,90,31,35,55,3029,19.82532751
Al-Farouq Aminu,202329,2017-18,84,29,24,5,35,79,28,34,45,4169,14.74820144
Jake Layman,1627774,2017-18,11,6,4,2,1,5,3,0,5,329,14.40217391
Meyers Leonard,203086,2017-18,17,11,8,3,4,10,0,7,3,522,16.28721541
Ed Davis,202334,2017-18,40,24,16,8,8,66,9,41,25,2852,12.29881567
Georgios Papagiannis,1627834,2017-18,9,5,5,0,1,8,0,6,2,247,17.85714286
Jusuf Nurkic,203994,2017-18,143,52,38,14,64,183,50,92,91,4206,26.34238787
Zach Collins,1628380,2017-18,52,21,15,6,15,58,16,32,26,2041,15.83044983
Caleb Swanigan,1628403,2017-18,14,7,6,1,7,18,2,11,7,372,19.63048499
Willie Cauley-Stein,1626161,2017-18,172,42,31,11,78,108,28,54,54,4027,21.97070573
De'Aaron Fox,1628368,2017-18,320,115,82,33,111,173,75,58,115,4065,23.18521777
Skal Labissiere,1627746,2017-18,72,33,25,8,16,73,18,36,37,2454,21.01449275
Bogdan Bogdanovic,203992,2017-18,258,84,66,18,109,125,64,45,80,4295,19.60825172
Iman Shumpert,202697,2017-18,17,8,8,0,5,16,8,6,10,565,12.85714286
Frank Mason,1628412,2017-18,147,52,31,21,47,65,26,26,39,1878,23.30827068
Vince Carter,1713,2017-18,69,24,19,5,29,36,18,16,20,2005,14.7396293
Garrett Temple,202066,2017-18,124,33,19,14,59,78,35,29,49,3160,16.4058133
Bruno Caboclo,203998,2017-18,4,1,1,0,2,4,4,0,4,207,16.10169492
Buddy Hield,1627741,2017-18,155,49,36,13,61,124,43,45,79,3956,24.29885573
Justin Jackson,1628382,2017-18,74,34,20,14,23,40,20,15,25,2985,14.23401689
JaKarr Sampson,203960,2017-18,9,4,4,0,1,8,1,6,2,666,12.70053476
Nigel Hayes,1628502,2017-18,6,5,5,0,0,2,1,0,2,224,13.79310345
Kosta Koufos,201585,2017-18,87,35,29,6,13,49,9,26,23,2692,15.41734861
Jack Cooley,204022,2017-18,6,1,1,0,2,3,0,3,0,162,19.59798995
Zach Randolph,2216,2017-18,127,37,28,9,50,116,39,47,69,2964,27.56352765
Kyle Anderson,203937,2017-18,202,77,62,15,81,94,40,42,52,3877,13.65820178
Kawhi Leonard,202695,2017-18,21,7,3,4,5,16,9,6,10,418,31.29102845
Brandon Paul,203464,2017-18,37,14,8,6,13,29,15,9,20,1171,13.38944147
Derrick White,1628401,2017-18,9,2,2,0,6,6,2,1,5,287,15.03067485
Dejounte Murray,1627749,2017-18,231,78,52,26,70,134,42,56,78,3421,20.73201945
Patty Mills,201988,2017-18,229,75,51,24,69,106,50,37,69,4149,17.6957352
Tony Parker,2225,2017-18,195,73,47,26,56,68,30,22,46,2106,20.8139042
Matt Costello,1627856,2017-18,2,2,2,0,0,1,0,0,1,64,7.142857143
Bryn Forbes,1627854,2017-18,80,31,20,11,25,37,8,18,19,3018,16.45643884
LaMarcus Aldridge,200746,2017-18,152,69,52,17,35,111,23,61,50,4862,29.35431362
Danny Green,201980,2017-18,110,27,13,14,34,74,40,26,48,3478,16.74242424
Pau Gasol,2200,2017-18,238,50,44,6,117,108,53,33,75,3566,20.66218571
Manu Ginobili,1938,2017-18,163,47,33,14,78,105,57,32,73,2603,21.11337407
Rudy Gay,200752,2017-18,73,28,20,8,32,77,28,35,42,2425,24.36219907
Darrun Hilliard,1626199,2017-18,11,5,4,1,4,4,0,3,1,193,12.26415094
Davis Bertans,202722,2017-18,74,28,16,12,27,36,19,13,23,2174,17.3679868
Joffrey Lauvergne,203530,2017-18,41,11,6,5,18,33,5,24,9,1083,20
CJ Miles,101139,2017-18,55,11,6,5,36,39,10,17,22,2714,22.08005249
OG Anunoby,1628384,2017-18,55,25,16,9,17,45,14,19,26,3000,12.40333135
Lorenzo Brown,203485,2017-18,13,9,7,2,3,3,0,2,1,271,12.66666667
Kyle Lowry,200768,2017-18,537,135,89,46,268,183,100,57,126,5118,21.46460254
Serge Ibaka,201586,2017-18,62,29,18,11,21,89,18,49,40,4268,19.33458883
DeMar DeRozan,201942,2017-18,417,201,145,56,136,175,67,62,113,5535,29.13663303
Malcolm Miller,1626259,2017-18,3,1,1,0,1,5,1,3,2,254,11.66666667
Jonas Valanciunas,202685,2017-18,81,40,32,8,27,115,21,59,56,3496,22.71461129
Malachi Richardson,1627781,2017-18,13,4,2,2,7,10,1,6,4,648,15.21438451
Fred VanVleet,1627832,2017-18,243,87,50,37,115,74,29,30,44,3008,19.47631656
Norman Powell,1626181,2017-18,89,40,26,14,33,66,17,34,32,2143,19.14983165
Alfonzo McKinnie,1628035,2017-18,1,1,1,0,0,3,2,1,2,113,15.96638655
Jakob Poeltl,1627751,2017-18,57,33,22,11,15,85,16,52,33,3040,14.77603258
Pascal Siakam,1627783,2017-18,159,69,49,20,75,67,24,30,37,3336,15.93391953
Delon Wright,1626153,2017-18,200,97,62,35,76,78,33,33,45,2848,17.380509
Lucas Nogueira,203512,2017-18,22,12,8,4,8,16,5,9,7,848,11.67567568
Joe Ingles,204060,2017-18,392,102,61,41,210,159,88,55,104,5130,15.94202899
Ricky Rubio,201937,2017-18,410,158,86,72,190,206,117,61,145,4458,22.87031469
David Stockton,204065,2017-18,0,0,0,0,0,1,1,0,1,21,25
Jonas Jerebko,201973,2017-18,42,20,18,2,12,27,8,16,11,2230,15.6761069
Alec Burks,202692,2017-18,67,26,15,11,28,60,19,26,34,2093,22.94372294
Dante Exum,203957,2017-18,43,14,12,2,18,20,8,10,10,474,23.10606061
Tony Bradley,1628396,2017-18,1,0,0,0,1,0,0,0,0,62,16.66666667
Derrick Favors,202324,2017-18,102,50,34,16,36,88,14,60,28,4221,18.65230249
Erik McCree,1628571,2017-18,0,0,0,0,0,1,0,0,1,16,16.66666667
Thabo Sefolosha,200757,2017-18,33,13,7,6,18,30,10,13,17,1590,16.78998293
Royce O'Neale,1626220,2017-18,95,38,19,19,38,55,22,24,31,2267,14.48034255
Raul Neto,203526,2017-18,75,35,22,13,26,36,22,12,24,1006,18.05183199
Rudy Gobert,203497,2017-18,80,30,25,5,26,106,16,58,48,3640,16.57310227
Georges Niang,1627777,2017-18,3,0,0,0,2,3,2,1,2,71,19.23076923
Ekpe Udoh,202327,2017-18,53,27,18,9,15,20,3,14,6,1614,9.249858996
Donovan Mitchell,1628378,2017-18,291,130,77,53,123,216,75,74,142,5268,28.88662593
Jae Crowder,203109,2017-18,99,45,34,11,40,74,23,41,33,4233,17.39316239
Chris McCullough,1626191,2017-18,4,1,1,0,2,2,1,0,2,199,22.36842105
John Wall,202322,2017-18,393,144,112,32,149,158,78,42,116,2897,28.77008653
Bradley Beal,203078,2017-18,373,132,95,37,121,214,88,70,144,5971,27.42899851
Markieff Morris,202693,2017-18,142,46,34,12,51,127,33,79,48,3912,19.85378113
Devin Robinson,1628421,2017-18,0,0,0,0,0,0,0,0,0,28,8.571428571
Tim Frazier,204025,2017-18,194,69,55,14,55,57,28,22,35,1652,13.00160514
Ramon Sessions,201196,2017-18,77,27,21,6,23,30,17,8,22,784,19.32960894
Kelly Oubre Jr.,1626162,2017-18,98,33,28,5,35,90,29,41,49,4523,19.30100137
Marcin Gortat,101162,2017-18,151,59,46,13,47,98,26,61,37,4147,15.71244081
Jason Smith,201160,2017-18,14,7,6,1,5,15,4,10,5,594,21.00456621
Jodie Meeks,201975,2017-18,70,18,14,4,22,37,17,15,22,2252,18.6228482
Otto Porter Jr.,203490,2017-18,157,51,40,11,50,75,31,29,46,4864,18.640955
Ian Mahinmi,101133,2017-18,53,14,12,2,21,101,23,66,35,2269,15.59984668
Mike Scott,203118,2017-18,80,32,24,8,30,79,18,45,34,2808,19.98738966
Tomas Satoransky,203107,2017-18,286,88,67,21,86,83,40,25,58,3284,13.79589633
Paul Millsap,200794,2016-17,252,96,54,42,111,158,55,63,95,4765,24.56008985
Malcolm Delaney,1627098,2016-17,193,74,60,14,79,95,50,34,61,2485,18.68289191
Ersan Ilyasova,101141,2016-17,141,48,36,12,66,116,42,56,60,4397,22.02369002
Dwight Howard,2730,2016-17,104,27,16,11,44,170,35,110,60,4407,19.33056051
Tim Hardaway Jr.,203501,2016-17,182,54,35,19,78,106,49,40,66,4379,22.36789028
Taurean Prince,1627752,2016-17,55,22,15,7,24,61,28,27,34,1985,17.16054843
Jose Calderon,101181,2016-17,88,24,20,4,32,41,27,10,31,1079,14.28571429
Dennis Schroder,203471,2016-17,499,160,120,40,216,258,124,88,170,5038,27.60070053
Kent Bazemore,203145,2016-17,177,41,26,15,99,125,66,34,91,3969,20.56595365
Thabo Sefolosha,200757,2016-17,107,39,29,10,39,58,26,24,34,3193,13.51949129
Ryan Kelly,203527,2016-17,8,2,2,0,5,4,1,2,2,219,14.58333333
Mike Muscala,203488,2016-17,95,40,30,10,33,55,26,21,34,2484,14.92007105
Mike Dunleavy,2399,2016-17,50,21,11,10,18,28,12,12,16,1692,14.20212766
Kris Humphries,2743,2016-17,29,10,9,1,9,28,6,15,13,1370,18.21127673
DeAndre' Bembry,1627761,2016-17,28,14,11,3,7,16,7,6,10,728,14.6878825
Avery Bradley,202340,2016-17,121,46,35,11,43,88,41,28,60,3682,21.87424132
Isaiah Thomas,202738,2016-17,449,192,133,59,171,210,76,70,140,5203,33.73556283
Jaylen Brown,1627759,2016-17,64,28,18,10,22,68,15,40,28,2661,18.24005394
Jonas Jerebko,201973,2016-17,71,34,29,5,21,39,15,19,20,2438,11.62705667
Demetrius Jackson,1627743,2016-17,3,0,0,0,3,0,0,0,0,35,16.27906977
Terry Rozier,1626179,2016-17,131,50,38,12,44,47,20,18,29,2507,17.25852273
James Young,203923,2016-17,4,2,1,1,1,4,2,1,3,453,12.79527559
Gerald Green,101123,2016-17,33,10,9,1,19,25,10,8,17,1070,22.93577982
Marcus Smart,203935,2016-17,364,141,104,37,163,159,70,61,98,4850,18.70067902
Kelly Olynyk,203482,2016-17,148,56,42,14,64,96,31,45,51,3094,19.08352668
Al Horford,201143,2016-17,337,123,81,42,138,115,46,44,71,4393,19.91803279
Tyler Zeller,203092,2016-17,42,15,14,1,15,20,10,8,12,1053,16.44182125
Jordan Mickey,1626175,2016-17,7,3,2,1,2,9,1,4,5,284,15.17027864
Amir Johnson,101161,2016-17,140,61,40,21,45,77,27,38,39,3156,13.81930763
Jae Crowder,203109,2016-17,155,63,44,19,58,80,39,30,50,4706,17.08341287
Randy Foye,200751,2016-17,135,62,41,21,41,80,36,33,47,2698,14.56016178
Sean Kilpatrick,203930,2016-17,157,72,52,20,55,135,45,48,87,3682,23.73872776
Jeremy Lin,202391,2016-17,184,54,35,19,90,86,37,29,57,1919,25.94517958
Spencer Dinwiddie,203915,2016-17,185,87,58,29,69,66,27,36,30,2731,14.35185185
Archie Goodwin,203462,2016-17,24,8,6,2,11,14,6,4,10,434,21.06382979
Brook Lopez,201572,2016-17,176,68,52,16,93,184,50,86,98,4706,28.95849347
Joe Harris,203925,2016-17,54,19,9,10,20,55,20,23,32,2425,16.17052554
Quincy Acy,203112,2016-17,18,6,3,3,9,21,5,10,11,1135,17.03296703
KJ McDaniels,203909,2016-17,13,2,0,2,10,29,11,10,19,1035,18.40753425
Isaiah Whitehead,1627785,2016-17,192,76,56,20,90,142,53,54,88,3391,18.45788223
Caris LeVert,1627747,2016-17,110,52,38,14,47,59,25,23,36,2625,16.52382585
Rondae Hollis-Jefferson,1626178,2016-17,154,67,54,13,57,116,46,44,72,3729,18.83528265
Trevor Booker,202344,2016-17,138,80,63,17,36,127,29,56,71,3647,18.88284726
Justin Hamilton,203120,2016-17,55,24,20,4,22,43,14,14,29,2469,16.19846771
Andrew Nicholson,203094,2016-17,10,4,3,1,3,17,3,9,8,677,17.73333333
Briante Weber,1627362,2016-17,21,12,10,2,3,8,3,2,6,382,17.20183486
Marvin Williams,101107,2016-17,106,40,38,2,39,60,18,35,25,4521,16.36076574
Jeremy Lamb,203087,2016-17,75,25,19,6,27,40,19,15,25,2217,23.43686971
Nicolas Batum,201587,2016-17,456,137,109,28,218,194,102,58,136,5212,21.85886403
Ramon Sessions,201196,2016-17,129,33,26,7,47,46,23,13,33,1640,19.92316136
Johnny O'Bryant III,203948,2016-17,6,4,4,0,2,6,1,4,2,164,21.19565217
Treveon Graham,1626203,2016-17,6,3,3,0,1,3,1,1,2,371,12.13592233
Michael Kidd-Gilchrist,203077,2016-17,114,52,42,10,30,56,11,30,26,4587,14.72463768
Kemba Walker,202689,2016-17,434,153,133,20,152,168,68,49,119,5422,29.08911217
Miles Plumlee,203101,2016-17,21,7,5,2,7,30,5,17,13,937,13.22001889
Marco Belinelli,201158,2016-17,147,53,41,12,56,70,30,23,47,3558,19.18856851
Brian Roberts,203148,2016-17,52,16,12,4,17,26,11,13,13,808,18.73589165
Christian Wood,1626174,2016-17,2,1,0,1,1,7,0,4,3,205,15.61181435
Cody Zeller,203469,2016-17,99,40,31,9,33,65,18,36,29,3406,15.55555556
Frank Kaminsky,1626163,2016-17,162,63,54,9,53,76,23,35,41,3893,22.06671332
Isaiah Canaan,203477,2016-17,37,13,8,5,11,21,9,11,10,1155,15.49925484
Jerian Grant,1626170,2016-17,121,30,22,8,48,44,21,17,27,2022,16.18472162
Dwyane Wade,2548,2016-17,228,62,31,31,101,138,66,42,96,3568,29.35359383
Bobby Portis,1626171,2016-17,35,16,11,5,12,37,8,25,12,1982,19.41618753
Cristiano Felicio,1626245,2016-17,40,22,16,6,11,33,7,15,18,2040,12.59038707
Michael Carter-Williams,203487,2016-17,113,42,26,16,30,66,28,27,39,1678,20.7498716
Robin Lopez,201577,2016-17,80,22,15,7,33,91,22,53,38,4490,17.44297489
Rajon Rondo,200765,2016-17,461,117,77,40,174,169,79,72,97,3667,17.74421897
Anthony Morrow,201627,2016-17,25,8,4,4,12,6,2,3,3,1461,16.04215457
Paul Zipser,1627835,2016-17,36,13,7,6,13,40,12,19,21,1674,14.56158664
Jimmy Butler,202710,2016-17,417,125,75,50,115,159,65,59,100,5588,26.47515528
Cameron Payne,1626166,2016-17,55,14,7,7,28,29,11,12,17,926,21.58548233
Nikola Mirotic,202703,2016-17,75,23,15,8,34,80,38,28,52,3352,19.8642652
Denzel Valentine,1627756,2016-17,63,24,14,10,16,49,21,22,27,1944,15.660463
Joffrey Lauvergne,203530,2016-17,70,19,12,7,32,56,17,28,28,1953,18.94783772
Kevin Love,201567,2016-17,116,40,22,18,64,122,43,47,75,3794,25.71756602
James Jones,2592,2016-17,14,7,5,2,4,10,5,4,6,755,13.69863014
Kyrie Irving,202681,2016-17,418,177,121,56,162,180,71,70,110,5064,29.90247301
Derrick Williams,202682,2016-17,28,14,10,4,10,28,6,18,10,1586,17.87137166
Iman Shumpert,202697,2016-17,109,47,29,18,38,78,32,37,41,3830,14.31924883
JR Smith,2747,2016-17,62,24,19,5,26,26,12,9,17,2372,14.5802099
Channing Frye,101112,2016-17,45,22,12,10,18,53,13,32,21,2793,19.80392157
Tristan Thompson,202684,2016-17,77,39,27,12,23,64,11,40,24,4622,11.36363636
Kay Felder,1627770,2016-17,58,34,22,12,15,30,11,15,15,775,25.0887574
LeBron James,2544,2016-17,646,349,188,161,199,302,131,118,184,5558,29.73877031
Richard Jefferson,2210,2016-17,78,32,24,8,30,52,14,32,20,3225,12.33566434
Kyle Korver,2594,2016-17,110,32,21,11,51,68,29,26,42,3554,15.00252143
Dahntay Jones,2563,2016-17,1,1,1,0,0,1,0,1,0,20,41.66666667
Deron Williams,101114,2016-17,360,149,113,36,105,138,67,49,89,3191,22.25085911
Edy Tavares,204002,2016-17,1,1,1,0,0,2,1,1,1,52,13.33333333
Nerlens Noel,203457,2016-17,50,16,12,4,25,51,10,28,23,2076,17.73633998
J.J. Barea,200826,2016-17,193,44,30,14,90,63,37,17,46,1497,26.20647526
Manny Harris,202412,2016-17,2,1,1,0,0,2,2,0,2,49,29.6875
Dwight Powell,203939,2016-17,49,27,20,7,12,34,10,17,17,2542,16.71957672
Nicolas Brussino,1627852,2016-17,47,12,10,2,22,26,11,12,14,1024,15.13327601
Dorian Finney-Smith,1627827,2016-17,67,40,20,20,13,45,16,20,25,3096,11.84172243
Yogi Ferrell,1627812,2016-17,172,75,56,19,41,70,33,26,44,2332,19.71830986
DeAndre Liggins,202732,2016-17,54,26,19,7,21,42,14,25,17,1532,11.62521689
Jarrod Uthoff,1627784,2016-17,9,4,3,1,2,3,1,0,3,222,17.12062257
AJ Hammons,1627773,2016-17,4,2,2,0,1,10,0,10,0,320,16.80216802
Wesley Matthews,202083,2016-17,210,101,79,22,37,102,40,34,68,4773,19.67748128
Seth Curry,203552,2016-17,189,67,56,11,52,92,36,48,44,3870,19.65003547
Devin Harris,2734,2016-17,136,41,31,10,56,57,28,20,37,2104,19.62978907
Harrison Barnes,203084,2016-17,116,90,69,21,11,102,34,33,69,5372,25.65677243
Dirk Nowitzki,1717,2016-17,82,38,27,11,27,51,17,19,32,2808,25.337282
Salah Mejri,1626257,2016-17,14,6,5,1,2,40,8,26,14,1700,10.77085533
Darrell Arthur,201589,2016-17,42,15,11,4,18,36,13,18,18,1287,18.03051318
Emmanuel Mudiay,1626144,2016-17,217,54,42,12,97,123,37,49,74,2900,22.49249249
Jameer Nelson,2749,2016-17,385,147,105,42,148,128,55,55,73,4166,15.82898853
Mike Miller,2034,2016-17,22,10,6,4,8,13,8,5,8,324,10.30640669
Will Barton,203115,2016-17,206,95,77,18,75,97,36,35,62,3460,21.07107107
Danilo Gallinari,201568,2016-17,135,39,32,7,61,82,33,26,56,4357,20.08830022
Gary Harris,203914,2016-17,164,79,60,19,61,76,37,28,48,3660,18.53365385
Nikola Jokic,203999,2016-17,359,97,80,17,214,171,60,73,98,4206,23.45936912
Wilson Chandler,201163,2016-17,141,73,54,19,42,114,33,57,57,4485,22.08121827
Mason Plumlee,203486,2016-17,284,96,78,18,120,134,47,60,74,4299,18.35390947
Malik Beasley,1627736,2016-17,11,3,3,0,5,8,2,5,3,359,21.71717172
Jamal Murray,1627750,2016-17,170,61,49,12,75,113,49,38,75,3614,21.61439339
Roy Hibbert,201579,2016-17,21,10,8,2,6,32,6,19,13,1369,14.05228758
Kenneth Faried,202702,2016-17,55,18,13,5,26,59,18,27,32,2631,18.23817292
Juan Hernangomez,1627823,2016-17,29,14,11,3,6,31,6,15,16,1740,14.3996014
Andre Drummond,203083,2016-17,90,32,23,9,26,153,29,85,68,4707,22.56277696
Reggie Jackson,202704,2016-17,270,91,69,22,88,114,57,42,72,2816,26.46967341
Kentavious Caldwell-Pope,203484,2016-17,193,57,47,10,78,86,30,33,53,5002,18.96249562
Darrun Hilliard,1626199,2016-17,33,12,6,6,9,28,12,12,16,746,19.59858323
Stanley Johnson,1626169,2016-17,105,26,21,5,42,71,21,37,34,2678,14.85917773
Henry Ellenson,1627740,2016-17,7,3,3,0,1,14,9,4,10,291,23.80952381
Michael Gbinije,1627771,2016-17,2,1,0,1,0,0,0,0,0,63,15.06849315
Aron Baynes,203382,2016-17,32,10,7,3,8,50,9,34,16,2280,14.48543689
Marcus Morris,202694,2016-17,160,31,21,10,65,87,48,27,60,5043,20.39120651
Ish Smith,202397,2016-17,418,151,107,44,137,112,49,30,82,3856,20.56561086
Beno Udrih,2757,2016-17,131,32,25,7,54,36,22,5,31,1087,20.09803922
Reggie Bullock,203493,2016-17,29,8,5,3,12,10,5,4,6,933,13.03538175
Jon Leuer,202720,2016-17,111,28,22,6,40,66,26,25,41,3819,17.31690623
Tobias Harris,202699,2016-17,142,50,33,17,45,96,24,39,57,5070,21.82166493
Boban Marjanovic,1626246,2016-17,9,1,0,1,5,10,1,5,5,589,24.33628319
Patrick McCaw,1627775,2016-17,77,30,21,9,34,36,19,13,23,2238,11.82539683
JaVale McGee,201580,2016-17,17,7,6,1,6,40,7,23,17,1581,22.40044248
David West,2561,2016-17,151,28,24,4,90,78,28,37,41,1667,19.63596249
Kevon Looney,1626172,2016-17,29,13,9,4,7,17,4,10,7,936,12.87313433
Andre Iguodala,2738,2016-17,261,85,63,22,106,58,29,23,35,4133,11.37109119
Klay Thompson,202691,2016-17,160,45,29,16,88,127,58,45,82,5472,26.27509049
Damian Jones,1627745,2016-17,0,0,0,0,0,6,0,6,0,171,13.7755102
James Michael McAdoo,203949,2016-17,18,6,4,2,5,19,6,9,10,924,14.84300666
Ian Clark,203546,2016-17,90,27,18,9,36,56,25,22,34,2320,19.76163014
Matt Barnes,2440,2016-17,195,58,36,22,85,107,57,40,67,3520,15.78947368
Draymond Green,203110,2016-17,533,182,146,36,224,184,99,71,113,5149,16.26369803
Zaza Pachulia,2585,2016-17,132,42,36,6,59,87,31,43,44,2638,15.29888551
Stephen Curry,201939,2016-17,524,163,113,50,270,239,119,89,150,5621,28.9741956
Shaun Livingston,2733,2016-17,139,41,26,15,47,62,28,25,37,2662,13.49899261
Kevin Durant,201142,2016-17,300,130,95,35,108,138,58,45,93,4353,27.63651521
Trevor Ariza,2772,2016-17,175,76,48,28,69,73,28,36,37,5779,14.19809874
Patrick Beverley,201976,2016-17,281,120,92,28,130,100,46,42,58,4246,14.21751764
Ryan Anderson,201583,2016-17,68,46,35,11,14,55,9,28,27,4374,18.11007689
Montrezl Harrell,1626149,2016-17,64,40,27,13,20,44,17,21,23,2204,17.34939759
Sam Dekker,1626155,2016-17,76,41,36,5,23,41,16,20,21,2920,15.13775356
Bobby Brown,201628,2016-17,14,6,6,0,8,5,1,3,2,269,22.37288136
Eric Gordon,201569,2016-17,188,75,45,30,98,121,41,52,69,4832,22.07198977
Lou Williams,101150,2016-17,239,39,26,13,149,160,84,48,112,4185,28.1986532
James Harden,201935,2016-17,907,368,272,96,481,464,219,150,314,6147,33.79489399
Troy Williams,1627786,2016-17,25,7,3,4,11,32,13,12,20,1106,17.20257235
Clint Capela,203991,2016-17,63,44,34,10,14,87,22,50,37,3164,20.20005557
Isaiah Taylor,1627819,2016-17,3,1,1,0,2,0,0,0,0,109,6.666666667
Chinanu Onuaku,1627778,2016-17,3,0,0,0,2,4,1,2,2,109,10.83333333
Kyle Wiltjer,1627787,2016-17,2,1,1,0,1,5,0,3,2,102,17.85714286
Nene ,2403,2016-17,65,36,22,14,27,73,19,38,35,2545,19.39986043
CJ Miles,101139,2016-17,48,13,7,6,22,40,19,15,25,3524,18.28093306
Aaron Brooks,201166,2016-17,125,32,23,9,32,66,31,22,44,1746,19.16916917
Kevin Seraphin,202338,2016-17,23,10,7,3,9,29,6,15,14,1114,18.99038462
Joe Young,1626202,2016-17,15,4,1,3,6,5,2,1,4,281,25.69659443
Lavoy Allen,202730,2016-17,57,21,14,7,18,29,16,7,22,1714,10.63723031
Lance Stephenson,202362,2016-17,59,24,17,7,21,26,14,9,17,714,18.55036855
Al Jefferson,2744,2016-17,57,23,17,6,11,33,6,17,16,1821,26.26213592
Monta Ellis,101145,2016-17,236,78,52,26,85,135,52,53,82,3965,17.01594533
Paul George,202331,2016-17,251,84,47,37,94,219,80,83,136,5375,28.95935234
Thaddeus Young,201152,2016-17,122,42,31,11,52,96,36,36,60,4478,16.63286004
Rakeem Christmas,1626176,2016-17,4,0,0,0,3,8,0,6,2,439,12.57253385
Georges Niang,1627777,2016-17,5,1,1,0,1,5,1,3,2,193,18.66666667
Myles Turner,1626167,2016-17,106,48,24,24,36,105,27,59,46,5086,19.79241231
Glenn Robinson III,203922,2016-17,47,19,15,4,12,37,13,11,26,2862,12.87878788
Jeff Teague,201952,2016-17,639,178,134,44,218,216,98,75,141,5349,22.16941097
Diamond Stone,1627754,2016-17,0,0,0,0,0,2,0,1,1,50,32.0754717
Raymond Felton,101109,2016-17,191,72,58,14,76,83,36,25,58,3383,16.6577967
Chris Paul,101108,2016-17,563,165,116,49,244,147,59,64,83,3833,24.28838077
JJ Redick,200755,2016-17,110,31,20,11,62,98,30,45,53,4414,21.51386359
Marreese Speights,201578,2016-17,65,27,19,8,27,69,22,39,30,2560,24.11221591
DeAndre Jordan,201599,2016-17,96,42,30,12,16,114,27,69,45,5114,15.43016371
Alan Anderson,101187,2016-17,11,1,1,0,9,7,2,4,3,605,14.04833837
Brice Johnson,1627744,2016-17,1,1,1,0,0,1,0,1,0,20,34.7826087
Jamal Crawford,2037,2016-17,214,65,44,21,112,134,52,48,86,4358,22.47516556
Luc Mbah a Moute,201601,2016-17,39,11,11,0,24,46,16,23,23,3527,11.69888098
Austin Rivers,203085,2016-17,204,95,72,23,61,115,38,47,68,4107,20.26643372
Brandon Bass,101138,2016-17,21,11,10,1,5,29,5,14,15,1141,19.92094862
Blake Griffin,201933,2016-17,300,125,83,42,108,142,58,51,91,4155,28.01890847
Wesley Johnson,202325,2016-17,23,9,7,2,7,18,9,6,12,1620,12.62626263
Paul Pierce,1718,2016-17,10,6,3,3,2,16,5,7,9,553,15.08196721
Nick Young,201156,2016-17,58,20,12,8,19,36,9,15,21,3185,19.44137168
D'Angelo Russell,1626156,2016-17,303,108,68,40,125,176,80,62,114,3718,26.76022835
Corey Brewer,201147,2016-17,97,35,26,9,42,55,14,27,28,2602,14.65897523
Jordan Clarkson,203903,2016-17,213,51,35,16,112,164,65,66,98,4927,23.20599786
Larry Nance Jr.,1626204,2016-17,96,27,17,10,42,56,26,23,33,2962,13.54415274
Luol Deng,2736,2016-17,74,31,21,10,29,43,21,14,29,3021,14.44444444
David Nwaba,1628021,2016-17,14,5,5,0,6,11,5,2,9,809,12.01764057
Tyler Ennis,203898,2016-17,86,28,20,8,40,45,26,15,30,1204,19.20821114
Brandon Ingram,1627742,2016-17,166,54,41,13,70,116,44,50,66,4637,16.94754781
Thomas Robinson,203080,2016-17,31,14,9,5,10,46,13,23,23,1131,20.60836502
Timofey Mozgov,202389,2016-17,43,19,14,5,11,72,15,45,27,2226,17.14623571
Tarik Black,204028,2016-17,39,19,13,6,10,58,10,35,23,2211,15.5226209
Julius Randle,203944,2016-17,264,139,108,31,63,173,45,89,84,4372,21.53225806
Metta World Peace,1897,2016-17,11,0,0,0,5,7,3,3,4,317,22.86501377
Ivica Zubac,1627826,2016-17,30,11,7,4,9,30,10,12,18,1273,20.50919378
JaMychal Green,203210,2016-17,84,31,27,4,36,94,35,47,47,3981,14.73637767
Jarell Martin,1626185,2016-17,8,3,1,2,3,28,7,16,12,1091,16.1752988
Wade Baldwin IV,1627735,2016-17,61,28,17,11,18,39,12,19,20,792,19.26091825
Andrew Harrison,1626150,2016-17,198,85,64,21,53,85,30,40,45,2813,16.58929124
Wayne Selden,1627782,2016-17,13,3,3,0,5,12,1,7,5,450,16.46090535
James Ennis III,203516,2016-17,64,23,12,11,26,59,17,25,34,2895,13.01059002
Tony Allen,2754,2016-17,98,24,18,6,41,100,35,45,55,3611,18.1555502
Mike Conley,201144,2016-17,433,144,109,35,142,156,74,51,105,4392,26.13908873
Vince Carter,1713,2016-17,133,39,28,11,53,50,23,22,28,3441,15.04312532
Deyonta Davis,1627738,2016-17,2,0,0,0,1,8,1,6,2,461,11.65413534
Chandler Parsons,202718,2016-17,55,23,12,11,14,24,10,11,13,1293,18.57541899
Troy Daniels,203584,2016-17,46,14,11,3,17,45,14,22,23,2323,20.90332214
Marc Gasol,201188,2016-17,338,127,90,37,139,166,45,70,96,4829,26.70920693
Brandan Wright,201148,2016-17,15,6,5,1,6,10,2,4,6,849,16.63201663
Zach Randolph,2216,2016-17,122,48,40,8,50,99,25,46,53,3406,28.80080281
Josh Richardson,1626196,2016-17,140,58,42,16,44,65,22,31,34,3174,16.84587814
Wayne Ellington,201961,2016-17,70,34,23,11,19,30,13,11,19,2946,17.80821918
Josh McRoberts,201177,2016-17,50,12,10,2,19,23,8,9,14,716,17.59708738
Luke Babbitt,202337,2016-17,36,16,14,2,10,25,10,13,12,2065,13.45657782
Goran Dragic,201609,2016-17,423,183,111,72,129,212,86,82,130,4869,26.66546633
Tyler Johnson,204020,2016-17,233,93,54,39,85,90,40,34,56,4324,20.78185133
Dion Waiters,203079,2016-17,200,99,65,34,63,103,36,49,54,2750,26.39381244
Okaro White,1627855,2016-17,21,14,9,5,5,18,3,13,5,906,10.98376313
James Johnson,201949,2016-17,276,112,65,47,109,171,64,80,91,4172,21.8895966
Rodney McGruder,203585,2016-17,124,48,29,19,47,56,19,25,31,3836,12.51999086
Justise Winslow,1626159,2016-17,66,21,10,11,25,33,11,15,18,1231,20.08639309
Hassan Whiteside,202355,2016-17,57,14,12,2,28,155,27,84,71,4925,22.66690278
Willie Reed,203186,2016-17,26,9,8,1,6,31,7,18,13,2034,15.51499348
Udonis Haslem,2617,2016-17,6,1,1,0,0,8,1,6,2,258,13.38028169
Spencer Hawes,201150,2016-17,81,18,15,3,40,49,18,25,24,1615,19.68325792
Gary Payton II,1627780,2016-17,13,7,5,2,4,10,4,3,7,195,16.19047619
Jason Terry,1891,2016-17,98,35,24,11,53,36,18,16,20,2639,9.834403515
Thon Maker,1627748,2016-17,23,7,4,3,13,17,8,7,10,1073,18.51225697
Matthew Dellavedova,203521,2016-17,357,95,69,26,184,133,77,46,87,3924,16
Michael Beasley,201563,2016-17,53,16,12,4,25,66,15,32,34,1847,24.84382508
Jabari Parker,203953,2016-17,142,52,30,22,62,93,26,44,49,3458,26.02704108
Malcolm Brogdon,1627763,2016-17,317,103,66,37,143,113,54,36,77,3866,18.53308653
Greg Monroe,202328,2016-17,187,57,36,21,99,140,39,58,82,3589,24.16291854
Rashad Vaughn,1626173,2016-17,23,4,2,2,12,14,5,4,10,907,17.09741551
Tony Snell,203503,2016-17,96,29,19,10,42,55,22,23,32,4582,12.23205506
Khris Middleton,203114,2016-17,99,26,15,11,64,65,36,21,44,1712,23.04417243
John Henson,203089,2016-17,57,19,13,6,22,52,7,33,19,2190,16.5993538
Giannis Antetokounmpo,203507,2016-17,434,192,144,48,151,234,58,128,106,5561,28.44952504
Mirza Teletovic,203141,2016-17,48,18,12,6,18,37,12,20,17,2218,19.25415484
Tyus Jones,1626145,2016-17,156,46,35,11,75,38,19,12,26,1534,13.5042735
Kris Dunn,1627739,2016-17,188,64,45,19,72,89,35,34,55,2572,14.3334447
Brandon Rush,201575,2016-17,45,10,6,4,16,28,9,16,12,2022,9.820254274
Gorgui Dieng,203476,2016-17,158,55,36,19,61,107,30,58,49,5198,14.23265237
Zach LaVine,203897,2016-17,139,29,26,3,50,85,34,31,54,3413,21.72915073
Ricky Rubio,201937,2016-17,682,149,85,64,322,195,120,58,137,4879,17.37563086
Shabazz Muhammad,203498,2016-17,35,10,8,2,12,56,10,35,21,2970,21.45772595
Omri Casspi,201956,2016-17,37,13,9,4,17,29,5,15,14,1265,14.11925977
Andrew Wiggins,203952,2016-17,189,63,34,29,61,187,56,67,120,6036,28.99854862
Jordan Hill,201941,2016-17,0,0,0,0,0,4,0,1,3,90,17.47572816
Karl-Anthony Towns,1626157,2016-17,220,67,55,12,83,211,60,111,100,5964,27.48058039
Adreian Payne,203940,2016-17,7,1,1,0,5,8,4,3,5,266,22.68370607
Cole Aldrich,202332,2016-17,25,9,6,3,6,17,1,12,5,1041,9.403862301
Nemanja Bjelica,202357,2016-17,79,24,14,10,36,59,18,27,32,2325,16.43682445
DeMarcus Cousins,202326,2016-17,332,134,77,57,129,269,70,119,150,4857,36.51261278
Tim Frazier,204025,2016-17,335,98,76,22,108,101,53,31,70,3090,16.47710703
Omer Asik,201600,2016-17,15,8,4,4,2,14,4,7,7,971,8.831646734
Jordan Crawford,202348,2016-17,57,14,10,4,33,25,10,11,14,888,25.84963955
Axel Toupane,1626253,2016-17,0,0,0,0,0,0,0,0,0,94,8.653846154
Jrue Holiday,201950,2016-17,488,171,125,46,183,194,87,61,133,4461,23.58069749
Donatas Motiejunas,202700,2016-17,32,10,7,3,8,30,10,11,19,985,17.26027397
Cheick Diallo,1627767,2016-17,4,2,2,0,1,7,0,3,4,406,20.39473684
Quinn Cook,1626188,2016-17,26,8,7,1,11,13,7,3,10,368,19.9017199
Anthony Davis,203076,2016-17,157,64,38,26,70,181,35,89,92,5500,32.5428195
Dante Cunningham,201967,2016-17,37,16,13,3,11,28,13,13,15,3320,10.91655267
Alexis Ajinca,201582,2016-17,12,3,2,1,5,31,4,19,12,1181,17.14939024
Solomon Hill,203524,2016-17,141,43,31,12,63,82,40,29,53,4846,11.5917603
E'Twaun Moore,202734,2016-17,164,50,35,15,60,62,28,26,36,3689,17.46692798
Maurice Ndour,1626254,2016-17,8,1,1,0,5,12,7,3,9,656,14.58885942
Chasson Randle,1626184,2016-17,34,10,8,2,12,19,8,9,10,601,19.67930029
Courtney Lee,201584,2016-17,179,60,39,21,58,69,29,28,41,4884,14.56692913
Kristaps Porzingis,204001,2016-17,97,39,27,12,24,118,30,55,63,4345,24.51417004
Carmelo Anthony,2546,2016-17,213,73,42,31,75,153,51,72,81,5064,29.03612395
Justin Holiday,203200,2016-17,102,25,15,10,49,66,33,24,42,3249,17.00426439
Kyle O'Quinn,203124,2016-17,117,25,21,4,62,76,24,40,36,2415,18.62535613
Joakim Noah,201149,2016-17,103,26,20,6,42,58,22,30,28,2011,12.63877028
Willy Hernangomez,1626195,2016-17,96,37,25,12,27,100,34,43,57,2657,20.28132156
Sasha Vujacic,2756,2016-17,52,14,10,4,21,16,8,6,10,816,17.11229947
Derrick Rose,201565,2016-17,283,114,76,38,81,147,61,55,92,4183,25.73866001
Ron Baker,1627758,2016-17,107,34,25,9,45,56,31,15,41,1672,15.23560209
Marshall Plumlee,1627850,2016-17,10,5,3,2,1,12,3,3,9,336,12.40694789
Lance Thomas,202498,2016-17,35,10,5,5,10,25,6,16,9,1909,13.36384439
Mindaugas Kuzminskas,1627851,2016-17,69,25,17,8,26,51,11,29,22,2040,18.973496
Russell Westbrook,201566,2016-17,840,206,130,76,471,438,238,136,302,5784,40.7688869
Domantas Sabonis,1627734,2016-17,82,39,21,18,25,83,17,49,34,3265,15.8768407
Nick Collison,2555,2016-17,12,2,1,1,10,4,2,2,2,253,9.933774834
Victor Oladipo,203506,2016-17,176,49,30,19,80,119,40,51,68,4532,21.32212457
Semaj Christon,203902,2016-17,130,45,31,14,49,43,18,19,24,1886,12.75045537
Alex Abrines,203518,2016-17,40,14,10,4,16,33,14,14,19,2172,15.6200318
Jerami Grant,203924,2016-17,46,19,12,7,17,44,11,23,21,3091,12.44369369
Enes Kanter,202683,2016-17,67,35,27,8,24,123,20,63,60,3082,27.68282432
Steven Adams,203500,2016-17,86,45,40,5,33,146,25,75,71,4878,16.06954689
Kyle Singler,202713,2016-17,9,2,2,0,4,11,3,6,5,775,11.34593993
Andre Roberson,203460,2016-17,79,32,17,15,29,51,20,14,37,4828,10.10533833
Taj Gibson,201959,2016-17,73,18,8,10,32,105,21,58,47,3945,19.05790838
Doug McDermott,203926,2016-17,58,20,17,3,19,38,10,20,18,2991,16.45459803
Norris Cole,202708,2016-17,14,1,1,0,7,7,4,2,5,252,22.06896552
Josh Huestis,203962,2016-17,3,3,2,1,0,0,0,0,0,67,14.1025641
Aaron Gordon,203932,2016-17,150,52,42,10,58,89,31,36,53,4598,20.09202454
Damjan Rudez,204014,2016-17,20,4,4,0,12,9,6,3,6,623,13.81766382
Elfrid Payton,203901,2016-17,529,148,118,30,196,178,76,66,112,4861,21.44153958
Mario Hezonja,1626209,2016-17,62,19,14,5,29,58,24,22,36,1891,19.1588785
Nikola Vucevic,202696,2016-17,208,94,77,17,68,117,36,59,58,4400,24.51807229
Evan Fournier,203095,2016-17,202,56,41,15,66,140,46,51,89,4493,23.2051785
Bismack Biyombo,202687,2016-17,74,26,24,2,19,95,19,60,35,3464,13.77382465
Marcus Georges-Hunt,1627875,2016-17,3,2,2,0,0,2,1,1,1,97,12.72727273
D.J. Augustin,201571,2016-17,209,65,55,10,74,90,45,32,58,3010,20.02366164
Jodie Meeks,201975,2016-17,45,21,15,6,19,36,17,10,26,1477,19.74483597
Patricio Garino,1627868,2016-17,0,0,0,0,0,3,0,3,0,87,10.20408163
Terrence Ross,203082,2016-17,88,31,23,8,38,68,27,25,43,3953,18.89163114
C.J. Watson,201228,2016-17,114,49,40,9,26,47,25,14,33,2020,14.16007036
Stephen Zimmerman,1627757,2016-17,4,1,1,0,2,3,1,2,1,211,14.51612903
Jeff Green,201145,2016-17,81,30,25,5,28,75,25,27,48,3030,20.52478134
Jerryd Bayless,201573,2016-17,13,6,5,1,5,9,3,3,6,140,28.93081761
T.J. McConnell,204456,2016-17,534,204,168,36,240,160,75,61,99,4414,14.48598131
Alex Poythress,1627816,2016-17,5,2,2,0,1,3,0,1,2,316,16.66666667
Jahlil Okafor,1626143,2016-17,58,25,20,5,23,90,9,48,42,2267,24.77424421
Dario Saric,203967,2016-17,182,70,51,19,70,183,58,91,92,4377,24.4732577
Nik Stauskas,203917,2016-17,188,65,51,14,80,128,49,48,80,4442,16.4745628
Gerald Henderson,201945,2016-17,112,58,44,14,37,62,24,26,36,3402,17.83671347
Sergio Rodriguez,200771,2016-17,344,104,85,19,180,128,67,42,86,3061,19.27607009
Timothe Luwawu-Cabarrot,1627789,2016-17,75,18,13,5,37,73,25,30,43,2473,17.8584392
Joel Embiid,203954,2016-17,66,32,28,4,24,117,15,63,54,1598,36.5
Richaun Holmes,1626158,2016-17,58,30,24,6,24,55,11,31,24,2439,18.73854052
Justin Anderson,1626147,2016-17,66,24,17,7,30,66,16,37,29,2426,20.68206821
Robert Covington,203496,2016-17,102,44,26,18,37,131,32,76,55,4353,19.11047929
Shawn Long,1627848,2016-17,13,4,2,2,6,13,0,8,5,478,24.59605027
Tiago Splitter,201168,2016-17,4,0,0,0,2,6,1,2,4,154,22.22222222
Marquese Chriss,1627737,2016-17,60,6,6,0,29,108,26,57,51,3646,19.75012013
Devin Booker,1626164,2016-17,268,94,61,33,119,241,94,91,150,5720,28.36846929
Eric Bledsoe,202339,2016-17,418,141,84,57,180,224,86,91,133,4540,27.88813886
Jared Dudley,201162,2016-17,121,27,21,6,52,73,33,28,45,2844,13.83570105
Tyson Chandler,2199,2016-17,30,11,8,3,10,65,18,44,21,2676,11.44538914
Tyler Ulis,1627755,2016-17,226,53,34,19,112,77,37,26,51,2351,20.34213462
Derrick Jones Jr.,1627884,2016-17,12,6,6,0,0,13,4,6,7,1136,11.84210526
Brandon Knight,202688,2016-17,130,54,40,14,44,88,36,31,57,2359,25.45657846
TJ Warren,203933,2016-17,75,21,10,11,43,57,20,27,30,4292,19.06211937
Ronnie Price,101179,2016-17,18,5,3,2,6,3,1,1,2,278,8.761329305
Alan Williams,1626210,2016-17,23,8,8,0,8,37,4,30,7,1476,20.64327485
Leandro Barbosa,2571,2016-17,81,22,14,8,40,48,21,16,32,1963,20.64923354
Alex Len,203458,2016-17,44,11,9,2,21,102,24,62,40,3244,17.66917293
Elijah Millsap,202407,2016-17,1,1,0,1,0,2,1,1,1,44,19.60784314
Dragan Bender,1627733,2016-17,23,3,1,2,15,32,10,15,17,1166,14.8455162
Damian Lillard,203081,2016-17,440,159,113,46,183,197,99,60,137,5438,30.80530401
Evan Turner,202323,2016-17,205,67,54,13,86,100,51,36,64,3329,18.67275658
CJ McCollum,203468,2016-17,285,122,86,36,94,172,70,57,115,5618,27.43488556
Maurice Harkless,203090,2016-17,88,41,32,9,23,86,22,42,44,4446,15.1984127
Pat Connaughton,1626192,2016-17,28,14,10,4,7,17,9,7,10,637,13.03116147
Shabazz Napier,203894,2016-17,67,31,23,8,24,41,14,15,26,1004,22.11101001
Al-Farouq Aminu,202329,2016-17,99,41,34,7,41,94,31,44,50,3520,15.86612161
Jake Layman,1627774,2016-17,11,6,6,0,2,11,1,6,5,512,19.04761905
Meyers Leonard,203086,2016-17,71,36,29,7,18,35,14,13,22,2481,15.88235294
Ed Davis,202334,2016-17,26,10,8,2,10,37,6,20,17,1563,12.11111111
Noah Vonleh,203943,2016-17,31,18,15,3,8,65,9,42,23,2506,13.21678322
Allen Crabbe,203459,2016-17,94,40,28,12,26,62,15,32,30,4567,14.92830485
Jusuf Nurkic,203994,2016-17,123,32,24,8,69,143,35,77,66,2818,23.66646229
Tim Quarterman,1627817,2016-17,11,4,2,2,2,11,8,2,9,166,22.77777778
Willie Cauley-Stein,1626161,2016-17,80,22,14,8,33,69,17,34,35,2774,20.08463542
Skal Labissiere,1627746,2016-17,27,7,7,0,9,37,11,12,25,1221,21.31268437
Malachi Richardson,1627781,2016-17,11,5,3,2,5,8,1,6,2,390,19.58041958
Darren Collison,201954,2016-17,312,130,110,20,115,114,56,42,72,4034,19.87965233
Rudy Gay,200752,2016-17,83,24,18,6,39,74,28,25,49,2008,25.09872751
Langston Galloway,204038,2016-17,93,39,31,8,25,46,23,15,31,3002,18.47401622
Ty Lawson,201951,2016-17,334,112,76,36,144,129,77,40,89,3441,19.46396045
Georgios Papagiannis,1627834,2016-17,20,5,5,0,6,24,5,11,13,702,17.076326
Garrett Temple,202066,2016-17,168,47,30,17,78,78,40,28,50,3409,14.2554319
Ben McLemore,203463,2016-17,51,16,12,4,21,62,19,29,33,2317,20.12432012
Buddy Hield,1627741,2016-17,121,46,35,11,38,101,38,35,66,3807,21.33682207
Tyreke Evans,201936,2016-17,124,53,38,15,37,61,24,29,32,1559,27.02078522
Arron Afflalo,201167,2016-17,78,29,22,7,20,42,13,23,19,3085,14.60345332
Kosta Koufos,201585,2016-17,47,17,12,5,12,61,13,30,31,2749,15.46158812
Kyle Anderson,203937,2016-17,91,33,26,7,35,39,9,23,16,2018,12.15201061
Kawhi Leonard,202695,2016-17,260,124,73,51,72,154,44,70,84,4815,31.16022099
Dewayne Dedmon,203473,2016-17,44,11,8,3,17,61,14,39,22,2560,12.15619694
Dejounte Murray,1627749,2016-17,48,11,7,4,23,38,16,13,25,635,23.69534556
Patty Mills,201988,2016-17,280,77,51,26,103,101,51,38,63,3520,18.92095358
Tony Parker,2225,2016-17,285,69,45,24,69,89,41,34,55,3011,20.81620669
David Lee,101135,2016-17,124,48,33,15,44,82,26,43,39,2938,16.58109333
Bryn Forbes,1627854,2016-17,23,7,7,0,7,11,4,5,6,563,17.7496038
LaMarcus Aldridge,200746,2016-17,139,67,48,19,32,98,25,45,53,4468,25.15313179
Danny Green,201980,2016-17,124,22,12,10,51,76,43,28,48,3441,13.8213463
Pau Gasol,2200,2016-17,150,37,25,12,75,81,35,23,58,3163,21.77236693
Jonathon Simmons,203613,2016-17,126,63,44,19,33,76,22,31,45,2742,18.06181584
Manu Ginobili,1938,2016-17,183,63,39,24,68,96,53,26,70,2639,19.48924731
Joel Anthony,201202,2016-17,3,1,0,1,1,4,2,2,2,247,8.759124088
Davis Bertans,202722,2016-17,46,18,10,8,20,32,12,15,17,1633,15.18780621
PJ Tucker,200782,2016-17,99,32,21,11,33,66,22,37,29,4519,11.34574774
DeMarre Carroll,201960,2016-17,74,27,23,4,27,54,15,27,27,3682,15.66666667
Cory Joseph,202709,2016-17,265,111,71,40,76,108,46,46,62,3938,18.39106145
Kyle Lowry,200768,2016-17,417,106,64,42,196,174,74,67,107,4403,24.77486492
Serge Ibaka,201586,2016-17,75,31,25,6,23,105,32,42,63,4796,21.16490447
DeMar DeRozan,201942,2016-17,290,132,86,46,85,180,63,54,126,5203,34.20738975
Jonas Valanciunas,202685,2016-17,57,25,18,7,16,106,22,60,46,4040,19.63163597
Bruno Caboclo,203998,2016-17,4,2,1,1,2,2,0,2,0,86,17.64705882
Fred VanVleet,1627832,2016-17,35,12,8,4,13,15,6,7,8,597,20.23809524
Norman Powell,1626181,2016-17,82,36,25,11,27,70,25,32,38,2717,21.20915033
Jakob Poeltl,1627751,2016-17,12,6,3,3,2,29,6,19,10,1219,12.05673759
Pascal Siakam,1627783,2016-17,17,6,4,2,9,33,10,15,18,1694,13.1292164
Patrick Patterson,202335,2016-17,76,37,27,10,26,38,14,21,17,3153,12.58408072
Delon Wright,1626153,2016-17,57,32,20,12,17,25,7,9,16,864,16.80080483
Lucas Nogueira,203512,2016-17,42,25,15,10,12,46,8,31,15,2156,9.533635988
Joe Ingles,204060,2016-17,225,68,37,31,125,107,52,39,68,3762,13.96396396
George Hill,201588,2016-17,204,83,47,36,77,85,43,25,60,2899,23.53121175
Rodney Hood,203918,2016-17,96,33,23,10,46,65,19,35,30,2999,23.22811197
Joe Johnson,2207,2016-17,144,61,32,29,59,69,22,24,45,3485,18.61182519
Shelvin Mack,202714,2016-17,154,67,45,22,52,90,37,36,54,2301,19.54334365
Alec Burks,202692,2016-17,30,5,3,2,19,35,8,20,15,1266,21.875
Dante Exum,203957,2016-17,111,34,23,11,55,80,34,31,49,2348,18.07458143
Derrick Favors,202324,2016-17,56,20,15,5,26,60,21,27,33,2225,21.06527833
Gordon Hayward,202330,2016-17,252,107,60,47,107,140,44,60,80,4774,27.39317037
Joel Bolomboy,1627762,2016-17,2,1,0,1,1,2,1,1,1,108,17.64705882
Jeff Withey,203481,2016-17,7,4,3,1,1,14,3,9,5,849,14.50939457
Raul Neto,203526,2016-17,34,13,10,3,17,15,6,7,8,669,14.55273698
Rudy Gobert,203497,2016-17,97,38,36,2,42,147,27,81,66,5173,16.88980433
Boris Diaw,2564,2016-17,170,62,47,15,86,87,38,35,52,2410,15.94202899
Trey Lyles,1626168,2016-17,69,37,28,9,24,64,21,32,32,2222,21.47704591
Chris McCullough,1626191,2016-17,2,0,0,0,2,3,1,1,2,168,19.37172775
John Wall,202322,2016-17,831,288,207,81,345,322,142,112,210,5824,30.2960928
Bradley Beal,203078,2016-17,267,85,57,28,88,156,58,66,90,5472,26.19434514
Markieff Morris,202693,2016-17,126,36,24,12,54,129,43,66,63,4809,20.58714919
Brandon Jennings,201943,2016-17,395,128,96,32,159,128,52,48,80,3642,17.56367131
Sheldon Mac,1627815,2016-17,15,3,3,0,5,5,1,2,3,568,14.28571429
Kelly Oubre Jr.,1626162,2016-17,47,17,15,2,11,50,13,23,27,3231,14.73742095
Marcin Gortat,101162,2016-17,121,55,40,15,38,119,30,67,52,5183,14.79391141
Jason Smith,201160,2016-17,37,12,11,1,13,58,19,33,25,2119,17.06299541
Otto Porter Jr.,203490,2016-17,121,33,20,13,47,44,21,17,27,5328,14.90745373
Ian Mahinmi,101133,2016-17,19,8,7,1,6,34,4,25,9,1112,14.24025457
Tomas Satoransky,203107,2016-17,92,29,24,5,28,38,15,12,26,1398,12.68323773
Daniel Ochefu,1627849,2016-17,3,3,1,2,0,3,0,2,1,150,18.12865497
Trey Burke,203504,2016-17,100,31,24,7,25,48,19,21,27,1364,20.5613577
Bojan Bogdanovic,202711,2016-17,111,45,29,16,45,131,41,54,77,4351,22.402665
Jeff Teague,201952,2015-16,470,153,117,36,175,218,92,71,147,4599,26.33647799
Paul Millsap,200794,2015-16,265,112,71,41,107,191,56,76,115,5357,24.15702063
Tim Hardaway Jr.,203501,2015-16,51,19,14,5,17,23,8,11,12,1714,16.37612256
Tiago Splitter,201168,2015-16,30,7,5,2,14,24,6,12,12,1159,15.50925926
Kirk Hinrich,2550,2015-16,73,25,19,6,21,30,17,9,21,1232,11.72316384
Lamar Patterson,203934,2015-16,39,13,10,3,18,23,5,14,9,799,12.68237935
Al Horford,201143,2015-16,263,101,66,35,105,107,38,48,59,5319,20.72210815
Dennis Schroder,203471,2015-16,349,136,115,21,133,183,82,66,117,3202,29.47160215
Edy Tavares,204002,2015-16,3,1,1,0,2,5,1,2,3,149,17.07317073
Kent Bazemore,203145,2015-16,171,38,30,8,85,138,54,55,83,4212,19.96561358
Thabo Sefolosha,200757,2015-16,107,38,30,8,49,68,23,32,36,3466,12.50973268
Kyle Korver,2594,2015-16,164,43,27,16,75,98,42,45,53,4917,13.36651917
Mike Muscala,203488,2015-16,34,11,6,5,15,27,10,12,15,1121,15.69255404
Mike Scott,203118,2015-16,78,27,17,10,38,42,13,21,21,2291,17.7029703
Kris Humphries,2743,2015-16,36,10,6,4,13,38,11,19,19,1700,19.375
Avery Bradley,202340,2015-16,158,36,29,7,73,109,43,45,64,5172,19.93916864
Isaiah Thomas,202738,2015-16,509,172,118,54,188,220,74,84,136,5479,29.31778239
Jared Sullinger,203096,2015-16,187,66,50,16,67,102,24,61,41,3888,21.93433103
Jonas Jerebko,201973,2015-16,62,18,16,2,24,52,12,29,23,2388,13.56673961
Evan Turner,202323,2015-16,359,99,75,24,183,169,84,49,120,4664,18.76053174
Terry Rozier,1626179,2015-16,37,18,15,3,10,19,8,4,15,635,17.33870968
James Young,203923,2015-16,9,5,4,1,3,5,0,5,0,407,9.492273731
RJ Hunter,1626154,2015-16,13,1,1,0,7,11,6,2,9,646,15.38461538
Marcus Smart,203935,2015-16,185,58,39,19,92,80,38,33,47,3467,17.16511686
Kelly Olynyk,203482,2015-16,105,33,21,12,46,74,12,44,30,2895,20.81818182
Tyler Zeller,203092,2015-16,29,6,4,2,11,46,9,25,21,1474,22.99880526
Jordan Mickey,1626175,2015-16,1,1,1,0,0,1,1,0,1,117,19.56521739
Amir Johnson,101161,2015-16,138,46,38,8,43,94,30,46,48,3619,13.83029722
Jae Crowder,203109,2015-16,135,35,27,8,71,83,37,38,45,4751,18.35268104
Shane Larkin,203499,2015-16,342,87,51,36,116,146,73,43,103,3460,17.57269279
Chris McCullough,1626191,2015-16,9,2,0,2,3,15,0,10,5,723,16.1097852
Jarrett Jack,101127,2015-16,236,37,24,13,88,94,47,28,66,2052,21.21598639
Sean Kilpatrick,203930,2015-16,29,12,9,3,11,31,10,9,22,1244,23.16305108
Sergey Karasev,203508,2015-16,35,11,5,6,14,22,13,4,18,812,12.03090508
Brook Lopez,201572,2015-16,146,39,29,10,72,175,49,82,93,4868,27.58304276
Henry Sims,203156,2015-16,9,1,0,1,5,12,3,8,4,531,17.08126036
Donald Sloan,202388,2015-16,268,62,44,18,105,80,43,23,57,2608,16.56845754
Wayne Ellington,201961,2015-16,83,23,16,7,34,45,23,15,30,3185,17.59285116
Markel Brown,203900,2015-16,91,20,13,7,45,54,26,15,39,1943,18.73315364
Rondae Hollis-Jefferson,1626178,2015-16,43,7,3,4,18,26,9,11,15,1229,13.25811001
Thaddeus Young,201152,2015-16,136,41,20,21,55,136,36,58,78,4738,22.01834862
Willie Reed,203186,2015-16,10,3,2,1,5,16,3,7,9,827,18.23899371
Thomas Robinson,203080,2015-16,46,10,6,4,25,69,12,38,31,1799,19.22348485
Bojan Bogdanovic,202711,2015-16,99,29,17,12,32,115,32,45,70,4177,19.46266131
Spencer Hawes,201150,2015-16,109,35,27,8,44,58,18,31,27,2054,17.27153476
Courtney Lee,201584,2015-16,136,43,27,16,34,72,29,30,42,4542,14.850702
Marvin Williams,101107,2015-16,110,50,39,11,30,62,20,33,29,4615,16.84782609
Jeremy Lamb,203087,2015-16,77,28,19,9,30,50,25,18,32,2442,21.90371187
Nicolas Batum,201587,2015-16,403,149,117,32,162,205,97,75,130,4866,21.22615299
Jeremy Lin,202391,2015-16,235,92,69,23,92,150,40,67,83,4071,22.26373626
Aaron Harrison,1626151,2015-16,2,0,0,0,1,4,0,4,0,203,13.42592593
Jorge Gutierrez,203268,2015-16,17,8,5,3,2,6,3,1,5,133,15.06849315
Michael Kidd-Gilchrist,203077,2015-16,9,6,4,2,2,8,1,7,1,399,17.7383592
Kemba Walker,202689,2015-16,421,195,160,35,135,171,70,54,117,5725,26.57156294
Al Jefferson,2744,2015-16,70,24,22,2,30,34,6,15,19,2164,24.63281578
Troy Daniels,203584,2015-16,21,6,3,3,6,24,8,9,15,967,19.98141264
Cody Zeller,203469,2015-16,71,31,20,11,19,68,11,41,27,3526,15.55498982
Frank Kaminsky,1626163,2015-16,98,51,41,10,25,58,11,30,28,3384,17.11568938
Tyler Hansbrough,201946,2015-16,8,4,3,1,3,12,2,8,4,682,14.63414634
Aaron Brooks,201166,2015-16,180,69,50,19,55,82,35,34,48,2181,23.15705128
Derrick Rose,201565,2015-16,311,91,54,37,93,175,72,67,108,4207,27.0625
Doug McDermott,203926,2015-16,59,22,19,3,19,53,17,22,31,3772,16.93811075
Bobby Portis,1626171,2015-16,52,24,21,3,16,54,15,25,29,2170,20.80832333
Cristiano Felicio,1626245,2015-16,26,12,10,2,11,13,2,6,7,639,13.77899045
Justin Holiday,203200,2015-16,56,14,11,3,26,39,19,14,25,1547,16.40670133
Spencer Dinwiddie,203915,2015-16,22,6,5,1,8,7,4,3,4,310,21.16991643
Joakim Noah,201149,2015-16,110,37,33,4,38,52,19,28,24,1246,14.06143345
Pau Gasol,2200,2015-16,294,81,64,17,160,164,81,47,117,4598,24.7313891
Tony Snell,203503,2015-16,63,12,5,7,20,52,18,26,26,2600,13.70695476
Jimmy Butler,202710,2015-16,321,103,72,31,83,132,54,45,87,4908,24.60686204
Taj Gibson,201959,2015-16,106,32,28,4,33,78,14,46,32,3772,14.77115118
Mike Dunleavy,2399,2015-16,39,11,6,5,14,26,17,7,19,1393,14.38485804
Cameron Bairstow,203946,2015-16,6,1,0,1,5,4,1,2,2,221,19.67213115
Nikola Mirotic,202703,2015-16,100,26,17,9,52,102,33,45,57,3317,21.25267666
E'Twaun Moore,202734,2015-16,99,27,20,7,38,53,17,22,31,2515,16.00700525
Kevin Love,201567,2015-16,185,68,48,20,87,142,62,52,90,4660,23.70148134
James Jones,2592,2015-16,14,6,3,3,5,13,4,7,6,922,15.79961464
Kyrie Irving,202681,2015-16,250,100,65,35,79,124,43,43,81,3216,29.11358092
Iman Shumpert,202697,2015-16,92,47,38,9,32,57,19,27,30,2550,13.33102493
JR Smith,2747,2015-16,130,51,32,19,50,59,18,30,29,4587,17.93602437
Matthew Dellavedova,203521,2015-16,337,114,78,36,168,116,59,41,75,3605,15.88035019
Channing Frye,101112,2015-16,71,22,18,4,27,43,14,24,19,2296,15.6009245
Jordan McRae,203895,2015-16,25,9,3,6,13,15,7,6,9,378,24.76415094
Tristan Thompson,202684,2015-16,62,38,30,8,14,61,10,35,26,4373,11.67955582
Sasha Kaun,201619,2015-16,3,1,1,0,1,7,1,5,2,203,12.60869565
Timofey Mozgov,202389,2015-16,33,13,9,4,8,71,13,38,33,2553,16.40488656
LeBron James,2544,2015-16,514,240,145,95,164,249,105,106,143,5253,31.06893107
Richard Jefferson,2210,2015-16,59,21,14,7,18,43,11,25,18,2578,13.60803324
Dahntay Jones,2563,2015-16,2,1,1,0,1,0,0,0,0,79,15.55555556
Mo Williams,2590,2015-16,98,27,19,8,52,57,21,29,28,1462,22.58258258
Justin Anderson,1626147,2015-16,29,12,10,2,11,24,10,8,16,1288,15.58171745
Raymond Felton,101109,2015-16,284,122,83,39,100,121,63,42,79,4286,18.43645485
Charlie Villanueva,101111,2015-16,24,4,2,2,15,31,9,17,14,1348,24.35473197
J.J. Barea,200826,2015-16,302,88,64,24,126,113,60,31,82,3296,23.53101197
Dwight Powell,203939,2015-16,44,20,19,1,13,40,8,20,20,1963,18.21917808
Deron Williams,101114,2015-16,378,149,119,30,115,150,72,51,99,4129,22.16393443
JaVale McGee,201580,2015-16,3,0,0,0,1,21,2,17,4,714,21.39303483
Jeremy Evans,202379,2015-16,2,0,0,0,1,7,3,3,4,518,11.24780316
Wesley Matthews,202083,2015-16,151,59,47,12,46,78,26,26,52,5133,17.44695774
Chandler Parsons,202718,2015-16,169,73,41,32,56,95,36,31,64,3494,20.85492228
Zaza Pachulia,2585,2015-16,128,45,38,7,44,119,25,61,58,3861,16.63581675
Devin Harris,2734,2015-16,118,32,21,11,54,66,31,29,37,2567,17.49649369
Dirk Nowitzki,1717,2015-16,132,60,32,28,52,84,30,31,53,4652,25.5389396
David Lee,101135,2015-16,84,35,20,15,23,66,18,27,39,1820,21.65200391
Salah Mejri,1626257,2015-16,10,4,3,1,3,23,5,12,11,777,14.26914153
Darrell Arthur,201589,2015-16,96,25,22,3,45,66,27,30,36,3016,16.88046647
Emmanuel Mudiay,1626144,2015-16,372,97,71,26,182,217,90,87,130,4171,25.38589904
Jameer Nelson,2749,2015-16,190,57,41,16,68,66,42,14,52,2027,16.60248181
Mike Miller,2034,2015-16,40,13,12,1,21,17,10,7,10,759,9.143518519
Will Barton,203115,2015-16,203,49,36,13,100,139,41,60,79,4676,23.06684142
Axel Toupane,1626253,2015-16,15,5,1,4,3,6,4,1,5,594,12.59484067
Danilo Gallinari,201568,2015-16,135,33,24,9,69,77,20,39,38,3679,22.94811321
JaKarr Sampson,203960,2015-16,46,23,17,6,14,70,13,36,34,2316,16.90087353
D.J. Augustin,201571,2015-16,198,49,27,22,94,84,34,34,50,2344,18.42105263
Gary Harris,203914,2015-16,147,40,30,10,65,98,29,44,54,4884,16.24158696
Nikola Jokic,203999,2015-16,189,60,40,20,93,104,33,50,54,3417,19.85869291
Jusuf Nurkic,203994,2015-16,40,12,8,4,20,55,10,28,27,1084,27.32371795
Kenneth Faried,202702,2015-16,79,30,26,4,33,91,22,45,46,3358,20.71957132
Joffrey Lauvergne,203530,2015-16,56,22,18,4,23,54,14,34,20,2048,20.00860585
Andre Drummond,203083,2015-16,67,30,17,13,22,155,32,78,77,5244,24.28851816
Reggie Jackson,202704,2015-16,492,166,114,52,205,223,109,70,153,4819,28.74776386
Kentavious Caldwell-Pope,203484,2015-16,138,59,36,23,52,105,32,44,61,5530,17.97456576
Darrun Hilliard,1626199,2015-16,27,12,9,3,5,19,4,12,7,753,19.60326721
Stanley Johnson,1626169,2015-16,118,46,28,18,46,114,33,59,55,3335,19.65678627
Spencer Dinwiddie,203915,2015-16,22,6,5,1,8,7,4,3,4,310,21.16991643
Aron Baynes,203382,2015-16,51,22,16,6,16,67,9,44,23,2444,18.93830703
Marcus Morris,202694,2015-16,201,71,42,29,76,140,56,64,76,5646,18.50828729
Lorenzo Brown,203485,2015-16,11,3,2,1,6,9,3,5,4,121,25.92592593
Jodie Meeks,201975,2015-16,3,1,0,1,2,1,0,1,0,81,25
Steve Blake,2581,2015-16,200,77,53,24,74,81,47,24,57,1934,14.83318305
Reggie Bullock,203493,2015-16,27,10,6,4,9,8,2,5,3,834,11.49897331
Tobias Harris,202699,2015-16,169,68,44,24,47,108,24,53,55,4941,19.55903272
Cameron Bairstow,203946,2015-16,6,1,0,1,5,4,1,2,2,221,19.67213115
Anthony Tolliver,201229,2015-16,52,20,14,6,16,28,11,15,13,2616,12.58278146
Joel Anthony,201202,2015-16,1,0,0,0,1,2,1,1,1,187,7.272727273
Brandon Rush,201575,2015-16,57,23,15,8,17,33,13,11,22,2170,12.79699875
Marreese Speights,201578,2015-16,61,22,17,5,21,66,11,34,32,1678,30.10526316
Andre Iguodala,2738,2015-16,219,90,66,24,96,79,38,28,51,3565,12.03082277
Klay Thompson,202691,2015-16,166,52,31,21,86,138,50,58,80,5558,26.31664499
Andrew Bogut,101106,2015-16,162,68,54,14,58,83,41,35,48,2973,11.68437026
Anderson Varejao,2760,2015-16,35,16,13,3,11,22,6,14,8,992,14.68531469
Leandro Barbosa,2571,2015-16,82,27,17,10,35,53,21,21,32,2206,17.93240557
James Michael McAdoo,203949,2015-16,17,7,7,0,4,16,5,8,8,546,19.68
Ian Clark,203546,2015-16,64,27,25,2,15,43,17,11,32,1169,19.89329268
Draymond Green,203110,2015-16,598,215,145,70,268,259,121,103,156,5892,18.68031159
Stephen Curry,201939,2015-16,527,168,122,46,264,262,114,106,156,5701,31.79026925
Festus Ezeli,203105,2015-16,32,19,12,7,3,38,11,18,20,1586,18.065592
Shaun Livingston,2733,2015-16,237,73,53,20,87,78,33,36,42,3041,14.39790576
Kevon Looney,1626172,2015-16,0,0,0,0,0,1,0,1,0,46,14.28571429
Harrison Barnes,203084,2015-16,117,61,45,16,33,57,16,31,26,4211,15.94202899
Andrew Goudelock,202726,2015-16,4,1,1,0,3,7,4,2,5,105,24.16666667
Trevor Ariza,2772,2015-16,188,80,52,28,78,113,48,51,62,5755,15.89041096
Patrick Beverley,201976,2015-16,239,88,55,33,104,91,38,44,47,4087,15.59613319
Josh Smith,2746,2015-16,90,28,10,18,43,77,36,31,46,1786,22.89276808
Terrence Jones,203093,2015-16,41,22,15,7,17,49,11,26,23,2108,19.44096788
Sam Dekker,1626155,2015-16,0,0,0,0,0,0,0,0,0,14,0
Michael Beasley,201563,2015-16,16,4,2,2,7,24,9,11,13,744,29.11832947
Dwight Howard,2730,2015-16,98,37,28,9,45,166,29,108,58,4566,18.765622
James Harden,201935,2015-16,612,234,128,106,294,374,181,114,260,6334,32.39085239
Clint Capela,203991,2015-16,47,14,11,3,24,60,13,30,30,2963,16.03252977
Donatas Motiejunas,202700,2015-16,41,14,10,4,23,44,19,19,25,1117,21.87748608
Jason Terry,1891,2015-16,103,43,30,13,49,49,31,15,34,2553,15.05154639
KJ McDaniels,203909,2015-16,10,2,1,1,4,17,6,9,8,480,18.72727273
Corey Brewer,201147,2015-16,109,39,23,16,56,78,38,25,53,3445,17.75724917
Montrezl Harrell,1626149,2015-16,17,9,7,2,8,17,6,8,9,778,14.60928652
CJ Miles,101139,2015-16,63,24,15,9,27,70,31,29,41,3019,22.50966399
Joe Young,1626202,2015-16,65,11,6,5,21,33,14,12,21,778,23.92776524
Rodney Stuckey,201155,2015-16,142,51,32,19,56,76,30,28,48,2527,20.72740113
George Hill,201588,2015-16,259,76,49,27,81,101,37,49,52,5035,16.00566572
Lavoy Allen,202730,2015-16,76,31,22,9,25,69,30,29,40,3117,13.15129563
Ty Lawson,201951,2015-16,237,83,50,33,106,95,57,27,68,2905,14.8385131
Monta Ellis,101145,2015-16,383,127,78,49,163,203,82,83,120,5540,21.06782107
Paul George,202331,2015-16,329,72,42,30,174,265,92,115,150,5726,30.06993007
Rakeem Christmas,1626176,2015-16,0,0,0,0,0,0,0,0,0,13,14.28571429
Jordan Hill,201941,2015-16,87,30,21,9,30,92,22,47,45,2978,20.51131355
Ian Mahinmi,101133,2015-16,104,44,29,15,27,100,22,62,38,3656,15.91576885
Myles Turner,1626167,2015-16,41,16,13,3,13,67,12,45,22,2782,21.11255693
Glenn Robinson III,203922,2015-16,26,5,2,3,12,18,8,5,13,1012,16.04831752
Shayne Whittington,203963,2015-16,3,1,1,0,1,5,0,4,1,83,17.70833333
Solomon Hill,203524,2015-16,57,16,8,8,23,33,12,16,17,1727,13.19514661
Chris Paul,101108,2015-16,738,234,174,60,295,194,92,73,121,4865,26.83243644
JJ Redick,200755,2015-16,106,37,22,15,49,78,33,31,47,4218,22.33404711
DeAndre Jordan,201599,2015-16,90,27,16,11,33,107,25,59,48,5163,15.65005228
Jeff Green,201145,2015-16,138,52,27,25,42,93,28,41,52,4358,20.83333333
Pablo Prigioni,203143,2015-16,130,48,27,21,47,49,28,14,35,1604,11.14221725
Jamal Crawford,2037,2015-16,183,51,36,15,100,113,44,43,70,4288,24.46360959
Luc Mbah a Moute,201601,2015-16,30,14,11,3,8,34,9,16,18,2462,9.751643535
Jeff Ayres,201965,2015-16,5,1,1,0,4,6,1,5,1,215,13.97379913
Branden Dawson,1626183,2015-16,0,0,0,0,0,0,0,0,0,57,8.196721311
Austin Rivers,203085,2015-16,99,47,26,21,24,61,23,24,37,2916,19.49705061
CJ Wilcox,203912,2015-16,10,2,2,0,2,2,1,1,1,341,19.51871658
Blake Griffin,201933,2015-16,170,71,49,22,45,83,26,31,52,2363,29.31818182
Wesley Johnson,202325,2015-16,49,19,16,3,24,54,22,25,29,3371,15.71199143
Paul Pierce,1718,2015-16,71,25,13,12,34,58,23,24,34,2439,18.16143498
Cole Aldrich,202332,2015-16,50,25,14,11,11,64,16,38,26,1549,19.10308678
Nick Young,201156,2015-16,34,10,9,1,16,30,7,16,14,2024,18.62278042
D'Angelo Russell,1626156,2015-16,266,77,61,16,106,196,81,74,122,4496,24.16291365
Brandon Bass,101138,2015-16,74,27,20,7,22,42,8,28,14,2673,13.9657444
Anthony Brown,1626148,2015-16,19,7,4,3,5,15,6,5,10,1192,11.03752759
Ryan Kelly,203527,2015-16,20,7,6,1,9,18,3,9,9,948,17.75092937
Jordan Clarkson,203903,2015-16,192,66,49,17,65,135,36,65,70,5096,22.89970553
Larry Nance Jr.,1626204,2015-16,44,17,12,5,11,40,10,21,19,2505,12.62714837
Marcelo Huertas,1626273,2015-16,182,51,37,14,87,80,50,20,60,1696,16.41713991
Roy Hibbert,201579,2015-16,95,26,19,7,27,76,21,43,33,3727,13.17165953
Lou Williams,101150,2015-16,167,43,27,16,79,107,51,34,73,3830,22.54856614
Kobe Bryant,977,2015-16,184,48,39,9,79,129,66,37,92,3766,31.79463024
Tarik Black,204028,2015-16,16,7,7,0,4,22,4,8,14,972,13.29739443
Julius Randle,203944,2015-16,144,71,55,16,37,149,38,74,75,4557,21.26592049
Metta World Peace,1897,2015-16,27,6,4,2,9,15,4,8,7,1133,16.69207317
Robert Sacre,203135,2015-16,14,6,5,1,2,12,3,8,4,650,14.05835544
JaMychal Green,203210,2015-16,67,17,14,3,29,83,12,50,33,2871,19.30992736
Lance Stephenson,202362,2015-16,133,33,22,11,67,94,30,50,44,2706,19.95464853
Jordan Adams,203919,2015-16,3,0,0,0,2,2,0,0,2,33,28.57142857
Jordan Farmar,200770,2015-16,37,9,5,4,16,18,9,7,11,567,18.04733728
Chris Andersen,2365,2015-16,12,4,3,1,6,9,4,3,6,762,11.18644068
Bryce Cotton,203955,2015-16,3,1,1,0,0,5,2,2,3,78,17.24137931
Tony Allen,2754,2015-16,70,11,9,2,27,78,26,33,45,3070,17.04927212
Jarell Martin,1626185,2015-16,15,5,4,1,6,19,4,9,10,741,18.3972912
Mike Conley,201144,2015-16,342,72,53,19,111,84,42,27,57,3377,23.01420305
Xavier Munford,204098,2015-16,22,3,3,0,13,15,3,9,6,480,17.04745167
Vince Carter,1713,2015-16,56,15,8,7,23,35,12,16,19,1995,17.99474606
PJ Hairston,203798,2015-16,38,14,12,2,12,41,15,18,23,2570,16.47589317
Matt Barnes,2440,2015-16,163,29,15,14,83,121,59,46,75,4274,17.77868186
Marc Gasol,201188,2015-16,196,57,46,11,74,118,31,47,71,3432,24.11128284
Brandan Wright,201148,2015-16,6,2,1,1,2,10,1,8,2,414,15.41755889
Zach Randolph,2216,2015-16,142,57,52,5,52,105,35,49,56,3878,24.98878421
Josh Richardson,1626196,2015-16,73,20,13,7,22,35,13,17,18,2143,13.7704918
Chris Bosh,2547,2015-16,128,36,23,13,50,78,29,28,50,3405,25.40940306
Joe Johnson,2207,2015-16,318,75,39,36,116,159,58,63,96,5326,18.04511278
Dwyane Wade,2548,2015-16,344,101,46,55,173,203,81,69,134,4399,31.69156237
Josh McRoberts,201177,2015-16,81,17,14,3,38,30,14,11,19,1147,15.29411765
Amar'e Stoudemire,2405,2015-16,27,6,1,5,7,47,7,28,19,1475,18.07155852
Goran Dragic,201609,2015-16,419,108,65,43,175,185,72,80,105,4634,21.60106484
Tyler Johnson,204020,2015-16,79,24,14,10,26,47,21,17,30,1641,17.13665944
Luol Deng,2736,2015-16,140,48,25,23,61,81,30,34,47,4695,17.19781256
Briante Weber,1627362,2015-16,21,6,5,1,12,9,7,1,8,333,11.84834123
Gerald Green,101123,2015-16,56,12,5,7,24,46,12,29,17,3023,19.75199291
Justise Winslow,1626159,2015-16,118,30,15,15,52,95,30,41,54,4345,12.47698916
Hassan Whiteside,202355,2015-16,29,3,2,1,17,135,22,82,53,4078,20.53475936
Udonis Haslem,2617,2015-16,14,3,3,0,6,5,1,4,1,492,13.77358491
O.J. Mayo,201564,2015-16,118,18,16,2,61,72,36,25,47,2153,16.87293729
Michael Carter-Williams,203487,2015-16,281,64,45,19,133,153,75,53,100,3275,21.01293103
Steve Novak,200779,2015-16,0,0,0,0,0,1,1,0,1,99,17.27272727
Tyler Ennis,203898,2015-16,95,22,14,8,43,46,25,15,31,1278,17.18641719
Jabari Parker,203953,2015-16,130,27,17,10,73,116,38,55,61,4727,20.91283202
Greg Monroe,202328,2015-16,178,54,38,16,82,129,31,58,71,4538,23.54549004
Damien Inglis,203996,2015-16,10,2,1,1,5,11,4,6,5,302,15.47619048
Miles Plumlee,203101,2015-16,16,2,1,1,4,40,12,22,18,1710,15.48353909
Jerryd Bayless,201573,2015-16,163,41,28,13,59,73,33,31,42,2909,16.71751068
Rashad Vaughn,1626173,2015-16,39,8,5,3,18,28,12,9,19,1954,13.37494427
Greivis Vasquez,202349,2015-16,91,24,17,7,43,40,19,17,23,878,18.75626881
Khris Middleton,203114,2015-16,331,42,23,19,208,180,75,68,112,5644,22.77585665
John Henson,203089,2015-16,54,13,10,3,26,64,18,32,32,1857,19.26345609
Giannis Antetokounmpo,203507,2015-16,345,64,41,23,161,208,63,110,98,5532,22.47801759
Johnny O'Bryant III,203948,2015-16,32,9,7,2,10,31,10,15,16,1635,13.80977969
Tyus Jones,1626145,2015-16,108,27,12,15,56,33,21,7,26,1130,15.74864236
Greg Smith,202962,2015-16,6,1,1,0,1,7,3,1,6,372,10.95571096
Gorgui Dieng,203476,2015-16,143,39,24,15,59,140,29,90,50,4362,16.94603434
Zach LaVine,203897,2015-16,251,52,40,12,108,155,51,65,90,4606,23.3281493
Ricky Rubio,201937,2015-16,658,82,61,21,292,193,103,62,131,4625,17.59953837
Damjan Rudez,204014,2015-16,11,2,0,2,4,13,5,8,5,553,12.68057785
Tayshaun Prince,2419,2015-16,74,17,15,2,23,27,6,14,13,2796,8.367540259
Nikola Pekovic,201593,2015-16,11,5,3,2,1,9,1,5,4,289,21.03658537
Shabazz Muhammad,203498,2015-16,52,13,8,5,27,70,18,38,32,3303,23.02543507
Kevin Garnett,708,2015-16,62,11,10,1,19,16,4,11,5,1079,11.75
Andrew Wiggins,203952,2015-16,164,43,30,13,53,182,53,71,111,5684,27.05827214
Karl-Anthony Towns,1626157,2015-16,161,41,33,8,66,183,49,105,78,5230,24.63472647
Adreian Payne,203940,2015-16,29,7,7,0,10,36,11,16,20,953,18.08014911
Nemanja Bjelica,202357,2015-16,82,18,11,7,40,47,13,21,26,2131,12.69709544
Tyreke Evans,201936,2015-16,164,62,47,15,53,73,25,32,41,1482,25.73134328
Tim Frazier,204025,2015-16,162,48,35,13,66,65,18,29,36,1477,19.61607678
Omer Asik,201600,2015-16,26,8,7,1,9,60,18,33,27,2330,11.63141994
James Ennis III,203516,2015-16,21,0,0,0,14,19,3,7,12,650,19.9192463
Kendrick Perkins,2570,2015-16,31,8,4,4,12,41,10,22,19,1091,10.62240664
Luke Babbitt,202337,2015-16,53,18,15,3,20,23,5,10,13,1736,17.0343766
Eric Gordon,201569,2015-16,121,29,16,13,46,73,17,37,36,2998,20.53923054
Jrue Holiday,201950,2015-16,391,119,90,29,155,167,85,47,120,3723,28.76712329
Alonzo Gee,202087,2015-16,72,28,23,5,24,55,13,31,24,3279,9.249658936
Toney Douglas,201962,2015-16,157,49,33,16,63,64,26,29,35,2557,19.26956522
Anthony Davis,203076,2015-16,116,42,33,9,50,121,22,65,56,4371,29.44078947
Jordan Hamilton,202706,2015-16,25,9,7,2,10,17,6,6,11,608,20.66957787
Norris Cole,202708,2015-16,167,36,28,8,67,75,40,24,51,2422,21.67034584
Ryan Anderson,201583,2015-16,73,28,17,11,26,90,19,48,42,4103,24.16630576
Alexis Ajinca,201582,2015-16,31,13,12,1,12,54,9,27,27,1719,20.60353798
Dante Cunningham,201967,2015-16,77,24,20,4,21,41,16,18,23,3949,11.13883848
Kevin Seraphin,202338,2015-16,47,6,4,2,18,43,11,23,20,1035,22.60034904
Langston Galloway,204038,2015-16,207,66,46,20,67,61,29,28,33,3979,15.46666667
Jose Calderon,101181,2015-16,298,98,65,33,80,87,52,21,66,3907,12.68589455
Arron Afflalo,201167,2015-16,144,47,39,8,33,82,21,41,41,4564,18.09542281
Tony Wroten,203100,2015-16,20,6,2,4,11,29,11,17,12,299,33.03834808
Kristaps Porzingis,204001,2015-16,94,36,24,12,30,121,35,48,73,3959,24.81719477
Carmelo Anthony,2546,2015-16,299,106,73,33,98,176,57,88,88,4910,29.56042
Robin Lopez,201577,2015-16,114,30,24,6,24,133,31,66,67,4266,17.73962804
Kyle O'Quinn,203124,2015-16,72,12,10,2,36,61,22,32,29,1488,21.22110255
Cleanthony Early,203921,2015-16,6,2,2,0,3,9,3,5,4,295,15.04424779
Jerian Grant,1626170,2015-16,177,64,40,24,58,87,48,24,63,2468,18.93533405
Lou Amundson,200811,2015-16,12,1,0,1,3,15,3,8,7,391,17.2489083
Sasha Vujacic,2756,2015-16,84,28,16,12,23,44,18,18,26,1780,16.43169665
Derrick Williams,202682,2015-16,75,22,20,2,23,61,19,22,39,2792,23.68337057
Lance Thomas,202498,2015-16,53,13,12,1,12,57,19,25,32,2552,17.11680112
Russell Westbrook,201566,2015-16,834,160,107,53,403,343,177,109,234,5578,31.52777778
Anthony Morrow,201627,2015-16,24,9,6,3,13,17,6,6,11,1860,17.08920188
Dion Waiters,203079,2015-16,154,66,40,26,52,120,43,58,62,4356,17.66213286
Nick Collison,2555,2015-16,52,8,7,1,26,50,23,20,30,1376,10.78250154
Kyle Singler,202713,2015-16,24,7,4,3,13,32,10,15,17,1976,11.62393162
Randy Foye,200751,2015-16,161,53,40,13,62,86,42,32,54,3229,16.07717042
Serge Ibaka,201586,2015-16,66,38,22,16,20,108,25,57,51,5036,17.6520994
Enes Kanter,202683,2015-16,33,16,16,0,7,115,13,77,38,3422,23.41850657
Steven Adams,203500,2015-16,62,22,15,7,17,84,15,56,28,4031,12.75641026
Nazr Mohammed,1737,2015-16,0,0,0,0,0,3,0,3,0,42,20
Andre Roberson,203460,2015-16,47,17,13,4,15,35,8,23,12,3082,9.36623668
Cameron Payne,1626166,2015-16,108,35,25,10,40,44,19,20,24,1386,20.40565458
Mitch McGary,203956,2015-16,3,1,0,1,0,7,2,3,4,160,20.11494253
Josh Huestis,203962,2015-16,0,0,0,0,0,3,2,0,3,111,13.49206349
Kevin Durant,201142,2015-16,361,105,39,66,140,250,102,77,173,5239,30.3426585
Aaron Gordon,203932,2015-16,128,27,20,7,59,66,13,36,30,3727,17.25684608
Dewayne Dedmon,203473,2015-16,13,5,5,0,5,32,6,19,13,1403,15.29263688
Elfrid Payton,203901,2015-16,467,113,84,29,181,177,81,66,111,4301,20.04880033
Victor Oladipo,203506,2015-16,282,78,54,24,92,153,61,56,97,4759,22.85555143
Ersan Ilyasova,101141,2015-16,67,24,15,9,20,71,17,45,26,3772,18.29157175
Nikola Vucevic,202696,2015-16,179,86,68,18,69,123,32,62,61,4051,26.83935568
Evan Fournier,203095,2015-16,214,42,28,14,75,133,52,46,87,5074,20.3567681
Devyn Marble,203906,2015-16,12,6,3,3,4,7,1,3,4,513,15.50522648
Shabazz Napier,203894,2015-16,97,37,27,10,26,46,21,20,26,1175,20.22813688
Jason Smith,201160,2015-16,62,20,15,5,21,57,16,34,23,2349,22.54114045
Mario Hezonja,1626209,2015-16,109,19,11,8,46,97,34,43,54,2833,17.00315457
C.J. Watson,201228,2015-16,88,26,17,9,24,25,9,14,11,1339,12.00269724
Andrew Nicholson,203094,2015-16,25,15,8,7,3,41,9,23,18,1624,20.8839779
Brandon Jennings,201943,2015-16,170,52,38,14,68,57,30,19,38,1753,19.75927783
Isaiah Canaan,203477,2015-16,137,50,41,9,55,91,42,39,52,3972,19.59247649
Ish Smith,202397,2015-16,502,173,135,38,210,175,93,42,133,4563,23.8861629
Nerlens Noel,203457,2015-16,122,39,30,9,62,158,41,71,87,3964,19.13357401
Kendall Marshall,203088,2015-16,73,23,15,8,32,43,19,19,24,834,18.33150384
Carl Landry,201171,2015-16,32,17,13,4,8,22,5,13,9,1161,24.22839506
Jahlil Okafor,1626143,2015-16,65,22,18,4,27,124,20,71,53,3154,27.83417936
Nik Stauskas,203917,2015-16,138,39,22,17,66,94,41,30,64,3700,16.67877027
T.J. McConnell,204456,2015-16,367,154,102,52,150,140,63,51,89,3223,17.22421897
Richaun Holmes,1626158,2015-16,33,12,8,4,15,32,6,17,15,1432,17.64342998
Hollis Thompson,203138,2015-16,99,34,21,13,45,76,30,38,38,4395,16.08377389
Robert Covington,203496,2015-16,97,31,21,10,54,143,38,71,72,3897,21.30884041
Christian Wood,1626174,2015-16,3,1,1,0,2,2,0,1,1,308,19.11764706
Jerami Grant,203924,2015-16,135,63,44,19,43,110,26,64,46,4155,18.49374191
Elton Brand,1882,2015-16,18,11,8,3,5,11,3,3,8,458,17.30382294
Devin Booker,1626164,2015-16,200,70,45,25,88,160,80,53,107,4301,23.20228152
Eric Bledsoe,202339,2015-16,190,67,48,19,80,110,53,43,67,2196,27.25806452
Brandon Knight,202688,2015-16,263,110,75,35,99,177,92,50,127,3838,26.23400366
Tyson Chandler,2199,2015-16,64,21,15,6,26,93,28,57,36,3256,12.84990669
Chase Budinger,201978,2015-16,64,16,13,3,32,44,17,22,22,1879,14.27247451
TJ Warren,203933,2015-16,44,17,14,3,11,32,10,16,16,2208,19.86491855
Ronnie Price,101179,2015-16,147,47,37,10,53,70,33,23,47,2466,13.76760563
Alan Williams,1626210,2015-16,5,2,2,0,3,6,1,4,2,151,20
PJ Tucker,200782,2015-16,177,58,43,15,74,111,37,60,51,5169,12.7190027
Archie Goodwin,203462,2015-16,118,41,29,12,39,100,48,31,69,2297,23.2204035
Alex Len,203458,2015-16,97,37,27,10,33,145,38,81,64,3710,20.53320861
John Jenkins,203098,2015-16,35,13,9,4,10,27,12,10,17,1013,17.04545455
Jon Leuer,202720,2015-16,72,28,23,5,29,75,33,29,46,2598,19.98633413
Mirza Teletovic,203141,2015-16,89,33,25,8,43,84,26,37,47,3494,23.31658291
Damian Lillard,203081,2015-16,512,193,126,67,202,242,125,77,165,5416,30.89141005
Brian Roberts,203148,2015-16,54,21,13,8,13,23,12,7,16,941,19.21274602
CJ McCollum,203468,2015-16,341,117,74,43,137,196,70,89,107,5573,27.12264151
Maurice Harkless,203090,2015-16,67,27,19,8,25,62,18,29,33,2924,15.63712325
Pat Connaughton,1626192,2015-16,10,5,4,1,3,10,5,2,8,294,18.31831832
Al-Farouq Aminu,202329,2015-16,138,59,40,19,49,120,32,58,62,4716,16.87755862
Gerald Henderson,201945,2015-16,75,31,23,8,30,68,24,34,34,2839,20.55555556
Meyers Leonard,203086,2015-16,92,42,31,11,25,77,28,38,39,2658,17.7
Ed Davis,202334,2015-16,88,32,22,10,25,64,12,37,27,3310,12.81045752
Noah Vonleh,203943,2015-16,30,17,11,6,7,50,6,37,13,2296,13.31562974
Allen Crabbe,203459,2015-16,99,36,28,8,38,64,17,31,33,4235,16.23578077
Mason Plumlee,203486,2015-16,226,91,67,24,77,154,50,68,86,4158,17.45863386
Cliff Alexander,1626146,2015-16,0,0,0,0,0,1,0,0,1,74,14.28571429
Chris Kaman,2549,2015-16,11,3,2,1,4,8,3,4,4,220,20.88353414
Luis Montero,1626242,2015-16,1,0,0,0,1,4,1,2,2,82,26.88172043
Willie Cauley-Stein,1626161,2015-16,37,11,11,0,19,46,15,17,29,2899,13.48484848
Marco Belinelli,201158,2015-16,127,44,28,16,51,80,39,29,51,3467,19.67128916
James Anderson,202341,2015-16,41,16,5,11,15,42,14,22,20,1500,13.74631268
Darren Collison,201954,2015-16,318,97,82,15,125,130,56,48,82,4591,19.29316338
Rudy Gay,200752,2015-16,120,41,28,13,54,139,49,48,91,4944,22.5499011
Rajon Rondo,200765,2015-16,839,195,135,60,386,278,131,117,161,5321,18.86352275
Quincy Acy,203112,2015-16,27,8,5,3,9,27,5,18,9,1800,13.18093385
DeMarcus Cousins,202326,2015-16,214,72,48,24,107,249,71,109,140,4720,35.46434651
Omri Casspi,201956,2015-16,95,20,16,4,50,94,37,45,49,3909,17.78129236
Ben McLemore,203463,2015-16,79,24,16,8,41,99,19,46,53,3035,17.4904943
Eric Moreland,203961,2015-16,1,1,1,0,0,3,0,2,1,103,9.821428571
Duje Dukan,1626251,2015-16,1,0,0,0,1,0,0,0,0,50,16.12903226
Seth Curry,203552,2015-16,67,19,13,6,28,36,13,21,15,1433,17.49379653
Caron Butler,2406,2015-16,10,4,1,3,4,3,1,1,2,363,16.42156863
Kosta Koufos,201585,2015-16,33,14,9,5,10,48,10,29,19,3030,15.53117783
Kyle Anderson,203937,2015-16,123,31,21,10,58,59,27,26,33,2426,14.55696203
Kawhi Leonard,202695,2015-16,186,53,40,13,59,105,30,53,52,4633,25.61823802
Patty Mills,201988,2015-16,226,46,31,15,79,76,40,22,54,3292,19.3960827
Tony Parker,2225,2015-16,379,83,61,22,105,131,48,54,77,3829,21.55898876
LaMarcus Aldridge,200746,2015-16,110,41,31,10,36,99,24,49,50,4375,26.15887278
Danny Green,201980,2015-16,141,33,18,15,48,75,31,31,44,3984,14.60699176
Matt Bonner,2588,2015-16,9,4,3,1,4,3,1,1,2,395,14.41860465
Jonathon Simmons,203613,2015-16,58,26,20,6,14,53,18,26,27,1599,18.74647092
Manu Ginobili,1938,2015-16,177,42,28,14,76,99,53,35,64,2268,23.23552736
Tim Duncan,1495,2015-16,163,28,19,9,83,90,39,34,56,2972,17.48210024
Kevin Martin,2755,2015-16,58,17,14,3,15,54,16,22,32,2191,22.21770918
Andre Miller,1889,2015-16,87,24,21,3,38,37,21,9,28,856,16.13236815
David West,2561,2015-16,143,40,22,18,72,68,25,36,32,2749,17.95543906
Boris Diaw,2564,2015-16,176,58,44,14,63,97,35,43,54,2760,16.77038978
Boban Marjanovic,1626246,2015-16,21,5,3,2,9,29,8,12,17,990,22.57777778
Jason Thompson,201574,2015-16,29,8,5,3,11,15,4,9,6,939,13.92285983
James Johnson,201949,2015-16,67,22,10,12,32,54,13,24,30,1764,16.19332337
Luis Scola,2449,2015-16,66,29,20,9,25,68,19,31,37,3170,19.50678858
DeMarre Carroll,201960,2015-16,27,15,9,6,8,28,11,7,21,1542,18.02358226
Cory Joseph,202709,2015-16,250,102,72,30,80,102,31,39,63,3958,17.01134089
Kyle Lowry,200768,2015-16,494,152,82,70,219,225,94,90,135,5484,26.09526844
Bismack Biyombo,202687,2015-16,29,14,12,2,9,71,6,51,20,3432,11.81563535
DeMar DeRozan,201942,2015-16,315,160,109,51,104,175,52,65,110,5445,29.56746288
Jonas Valanciunas,202685,2015-16,42,22,16,6,14,85,10,61,24,3014,20.82000582
Bruno Caboclo,203998,2015-16,1,1,1,0,0,4,2,2,2,89,15.53398058
Norman Powell,1626181,2015-16,47,23,14,9,12,32,10,16,16,1399,17.8125
Terrence Ross,203082,2015-16,56,21,11,10,28,46,9,23,23,3356,18.28916295
Patrick Patterson,202335,2015-16,94,36,25,11,30,65,22,26,39,3865,13.04744526
Delon Wright,1626153,2015-16,31,13,7,6,10,16,6,8,8,448,22.28796844
Lucas Nogueira,203512,2015-16,7,2,2,0,4,11,1,7,4,442,12.52525253
Joe Ingles,204060,2015-16,96,27,18,9,54,65,34,28,37,2390,13.32110092
Trey Burke,203504,2015-16,148,46,24,22,67,80,35,28,52,2598,24.8502994
Rodney Hood,203918,2015-16,213,79,49,30,81,125,51,42,83,4724,21.92998703
Shelvin Mack,202714,2015-16,187,58,34,24,75,95,45,30,65,2027,23.25783972
Alec Burks,202692,2015-16,63,20,11,9,32,51,19,24,27,1540,25.15510434
Derrick Favors,202324,2015-16,94,43,27,16,32,104,34,53,51,3744,23.92982456
Gordon Hayward,202330,2015-16,296,112,57,55,124,202,63,87,115,5503,25.54140127
Tibor Pleiss,202353,2015-16,2,1,1,0,1,8,1,6,2,156,19.54022989
Chris Johnson,203187,2015-16,45,13,7,6,23,40,12,20,20,1629,13.64617044
Jeff Withey,203481,2015-16,20,13,11,2,3,28,7,16,12,1229,15.48893647
Raul Neto,203526,2015-16,174,50,19,31,91,109,53,37,72,2805,17.61363636
Rudy Gobert,203497,2015-16,91,34,29,5,30,114,28,59,55,3613,14.61054669
Trevor Booker,202344,2015-16,83,42,25,17,23,81,22,48,33,3088,14.48179272
Trey Lyles,1626168,2015-16,59,36,24,12,14,65,19,36,29,2591,18.32139202
Jared Dudley,201162,2015-16,171,52,34,18,79,80,40,22,58,4240,12.98977853
John Wall,202322,2015-16,789,276,187,89,293,318,158,107,211,5699,28.39855414
Bradley Beal,203078,2015-16,162,52,37,15,62,112,28,50,62,3504,25
Markieff Morris,202693,2015-16,124,45,31,14,52,135,41,72,63,3326,24.35522467
Alan Anderson,101187,2015-16,14,3,1,2,8,2,2,0,2,388,15.63981043
Ramon Sessions,201196,2015-16,239,60,50,10,91,115,45,50,65,3417,22.04828867
Jarell Eddie,204067,2015-16,5,1,1,0,4,1,0,0,1,315,19.66292135
Kelly Oubre Jr.,1626162,2015-16,13,3,2,1,7,34,8,18,16,1389,17.08575113
Marcin Gortat,101162,2015-16,106,33,26,7,39,121,29,66,55,4590,18.93147503
Marcus Thornton,201977,2015-16,84,24,15,9,53,51,21,19,32,2296,24.12466333
Garrett Temple,202066,2015-16,140,40,29,11,48,64,26,22,42,3954,14.30530165
JJ Hickson,201581,2015-16,23,8,5,3,7,25,10,10,15,899,22.35294118
Otto Porter Jr.,203490,2015-16,120,29,19,10,62,70,20,34,36,4661,16.13645075
Nene ,2403,2015-16,97,20,10,10,50,76,20,35,41,2234,22.47933884
Drew Gooden,2400,2015-16,13,5,4,1,2,13,6,4,9,626,17.40370899
Jeff Teague,201952,2014-15,513,158,112,46,200,205,87,77,128,4415,25.12685204
Austin Daye,201948,2014-15,17,3,1,2,8,23,7,12,11,687,21.5483871
Paul Millsap,200794,2014-15,223,83,47,36,72,166,37,86,80,4707,23.64980102
DeMarre Carroll,201960,2014-15,118,49,37,12,37,75,26,39,36,4286,16.79151061
Pero Antic,203544,2014-15,49,22,14,8,16,49,18,24,25,2056,17.14778113
Elton Brand,1882,2014-15,22,10,7,3,6,18,4,10,8,938,11.76470588
Shelvin Mack,202714,2014-15,155,42,31,11,57,49,24,14,35,1620,19.57964602
John Jenkins,203098,2014-15,13,5,3,2,4,8,3,2,6,597,17.26726727
Al Horford,201143,2014-15,244,116,63,53,81,100,28,50,50,4503,22.57612179
Dennis Schroder,203471,2014-15,317,127,93,34,80,150,61,58,92,2884,27.62550046
Kent Bazemore,203145,2014-15,78,30,25,5,33,73,18,33,40,2565,15.65005228
Thabo Sefolosha,200757,2014-15,75,31,21,10,24,38,7,20,18,1854,14.78507322
Kyle Korver,2594,2014-15,196,34,23,11,103,107,49,46,61,4770,14.18560606
Mike Muscala,203488,2014-15,25,9,5,4,8,21,1,15,6,980,16.31016043
Mike Scott,203118,2014-15,75,33,22,11,25,39,10,23,16,2156,22.07792208
Avery Bradley,202340,2014-15,135,23,16,7,55,109,35,50,59,4891,20.97385032
Isaiah Thomas,202738,2014-15,284,128,87,41,86,143,39,53,90,3489,27.65957447
Jared Sullinger,203096,2014-15,134,53,29,24,44,78,21,45,33,3120,23.51789709
Jonas Jerebko,201973,2014-15,71,34,27,7,20,44,13,24,20,2366,16.44832606
Evan Turner,202323,2014-15,449,91,72,19,205,198,90,72,126,4501,19.63834338
James Young,203923,2014-15,13,4,1,3,2,5,4,1,4,668,15.36491677
Phil Pressey,203515,2014-15,117,43,34,9,43,41,12,23,18,1182,17.65140325
Brandon Bass,101138,2014-15,104,46,33,13,18,83,13,55,28,3790,19.99534992
Marcus Smart,203935,2014-15,208,55,43,12,85,90,40,26,64,3558,15.24674687
Kelly Olynyk,203482,2014-15,109,30,22,8,42,98,21,57,41,2888,21.06544901
Tyler Zeller,203092,2014-15,113,28,25,3,27,76,20,36,40,3441,19.91297671
Gerald Wallace,2222,2014-15,11,4,4,0,4,18,7,9,9,554,9.291338583
Gigi Datome,203540,2014-15,9,1,0,1,7,9,3,4,5,412,20.54507338
Jae Crowder,203109,2014-15,94,35,27,8,38,49,19,25,24,3263,17.31430082
Jarrett Jack,101127,2014-15,373,94,63,31,156,191,84,66,125,4350,22.62147815
Mason Plumlee,203486,2014-15,74,21,13,8,31,106,20,58,48,3310,19.65811966
Alan Anderson,101187,2014-15,83,25,13,12,35,60,21,30,30,3385,14.22583181
Joe Johnson,2207,2014-15,292,89,49,40,100,137,57,45,92,5349,20.59018568
Deron Williams,101114,2014-15,448,113,79,34,167,154,71,51,103,4090,22.20782026
Jerome Jordan,202366,2014-15,13,2,2,0,6,22,7,10,12,747,15.71594878
Sergey Karasev,203508,2014-15,46,12,7,5,17,24,8,14,10,1085,14.15857605
Brook Lopez,201572,2014-15,50,21,13,8,12,104,16,55,49,4059,26.19669278
Darius Morris,202721,2014-15,48,20,14,6,17,21,12,3,18,569,19.81707317
Cory Jefferson,203928,2014-15,16,6,3,3,7,20,4,6,14,1047,17.41988496
Markel Brown,203900,2014-15,39,12,7,5,16,27,11,10,17,1529,14.99148211
Thaddeus Young,201152,2014-15,173,39,24,15,78,117,40,37,80,4758,21.52384433
Mirza Teletovic,203141,2014-15,46,14,9,5,19,53,11,22,31,1724,20.12288786
Bojan Bogdanovic,202711,2014-15,68,23,15,8,23,78,18,35,43,3564,17.36763978
Earl Clark,201947,2014-15,3,1,1,0,1,6,0,4,2,188,17.84037559
Lance Stephenson,202362,2014-15,240,59,40,19,77,128,50,54,74,3042,21.00203903
Marvin Williams,101107,2014-15,100,27,22,5,36,60,19,36,24,3964,13.40252708
Mo Williams,2590,2014-15,424,67,36,31,195,172,86,57,115,3901,24.69273743
Bismack Biyombo,202687,2014-15,16,9,7,2,3,52,7,28,24,2348,11.69163318
Gerald Henderson,201945,2014-15,206,39,29,10,65,110,39,49,61,4454,21.03269537
Noah Vonleh,203943,2014-15,4,1,1,0,1,11,3,5,6,498,17.06484642
Michael Kidd-Gilchrist,203077,2014-15,77,14,10,4,23,63,6,38,25,3036,18.39311334
Kemba Walker,202689,2014-15,318,70,51,19,117,100,37,32,68,4059,25.77097261
PJ Hairston,203798,2014-15,21,6,4,2,8,22,7,11,11,1341,19.64056483
Brian Roberts,203148,2014-15,162,52,36,16,46,57,30,17,40,2543,18.65929509
Al Jefferson,2744,2014-15,113,29,27,2,52,68,17,35,33,3845,26.87996263
Troy Daniels,203584,2014-15,22,8,6,2,7,20,9,7,13,788,20.76086957
Cody Zeller,203469,2014-15,100,16,14,2,38,62,27,29,33,2856,15.63169165
Jeffery Taylor,203106,2014-15,22,6,3,3,8,19,5,9,10,820,16.39522258
Jason Maxiell,101131,2014-15,19,4,3,1,6,29,4,19,10,1690,12.95073641
Aaron Brooks,201166,2014-15,261,81,48,33,94,157,70,59,98,3629,25.16826923
Derrick Rose,201565,2014-15,251,65,42,23,78,161,61,71,90,3013,31.05733218
Doug McDermott,203926,2014-15,6,2,2,0,2,17,3,12,5,625,18.59799714
Kirk Hinrich,2550,2014-15,148,39,27,12,50,73,43,25,48,3116,13.26105088
Joakim Noah,201149,2014-15,312,85,75,10,134,123,50,59,64,3955,13.81118881
Pau Gasol,2200,2014-15,210,85,64,21,85,158,61,56,102,5232,24.62102282
Tony Snell,203503,2014-15,62,19,12,7,30,48,23,18,30,2715,14.23979428
Jimmy Butler,202710,2014-15,212,68,43,25,67,93,32,44,49,4851,21.69491525
Taj Gibson,201959,2014-15,71,30,29,1,20,77,12,46,31,3211,17.88008565
Mike Dunleavy,2399,2014-15,114,26,21,5,49,60,21,23,37,3524,14.26802081
Cameron Bairstow,203946,2014-15,1,0,0,0,0,3,0,3,0,127,12.92517007
Nikola Mirotic,202703,2014-15,97,31,22,9,43,89,28,40,49,3172,23.15963606
Nazr Mohammed,1737,2014-15,3,1,1,0,1,7,3,4,3,247,13.4751773
E'Twaun Moore,202734,2014-15,33,11,8,3,14,14,7,6,8,973,14.50177936
Kevin Love,201567,2014-15,168,30,21,9,98,122,42,50,72,4884,21.78182467
James Jones,2592,2014-15,24,9,4,5,7,13,6,4,9,1306,15.69293478
Kyrie Irving,202681,2014-15,389,129,85,44,185,186,72,64,122,5294,25.86974444
Kendrick Perkins,2570,2014-15,51,18,15,3,19,95,19,61,34,2243,13.98519673
Iman Shumpert,202697,2014-15,135,56,39,17,42,91,33,40,51,2917,17.68055139
JR Smith,2747,2014-15,195,66,45,21,73,97,50,30,67,4022,19.20486639
Matthew Dellavedova,203521,2014-15,204,78,58,20,79,61,39,16,45,2607,12.81456954
Joe Harris,203925,2014-15,26,13,9,4,8,27,7,17,10,973,13.99817017
Tristan Thompson,202684,2014-15,39,27,23,4,5,83,12,54,29,4159,14.1443299
Anderson Varejao,2760,2014-15,35,7,5,2,25,35,6,21,14,1207,18.65889213
Mike Miller,2034,2014-15,46,13,11,2,16,23,13,9,14,1356,9.049479167
Timofey Mozgov,202389,2014-15,55,21,18,3,16,116,17,64,52,3997,16.92640693
LeBron James,2544,2014-15,511,208,126,82,207,272,114,113,159,4805,32.37331389
Shawn Marion,1890,2014-15,51,17,11,6,15,33,12,15,18,2097,12.91377197
Brendan Haywood,2217,2014-15,2,2,2,0,0,10,2,5,5,238,17.37451737
Amar'e Stoudemire,2405,2014-15,45,14,11,3,9,78,5,43,35,2373,23.85861561
Raymond Felton,101109,2014-15,41,20,13,7,14,18,7,9,9,565,20.46875
Charlie Villanueva,101111,2014-15,19,6,4,2,7,28,8,13,15,1390,26.05633803
Greg Smith,202962,2014-15,9,3,1,2,1,11,3,7,4,710,10
J.J. Barea,200826,2014-15,263,72,55,17,117,70,35,22,48,2664,21.60186108
Tyson Chandler,2199,2014-15,84,13,10,3,24,105,20,62,43,4534,12.88810779
Al-Farouq Aminu,202329,2014-15,59,25,17,8,22,55,15,31,24,2693,15.07782101
Dwight Powell,203939,2014-15,9,5,3,2,2,11,2,5,6,482,16.90647482
Rajon Rondo,200765,2014-15,538,164,110,54,196,210,113,74,136,4075,19.45355191
Monta Ellis,101145,2014-15,329,132,103,29,140,198,83,68,130,5422,27.6746097
Devin Harris,2734,2014-15,237,77,50,27,110,85,36,38,47,3345,18.03538421
Richard Jefferson,2210,2014-15,61,24,19,5,17,52,17,27,25,2459,15.549112
Chandler Parsons,202718,2014-15,161,52,32,20,71,96,28,34,62,4355,20.42224929
Dirk Nowitzki,1717,2014-15,143,53,32,21,67,82,31,30,52,4502,25.128611
Bernard James,203108,2014-15,4,1,1,0,0,6,0,3,3,309,12.18836565
Darrell Arthur,201589,2014-15,57,19,12,7,25,47,19,21,26,1991,20.37201063
Ty Lawson,201951,2014-15,720,225,160,65,287,185,103,50,135,5386,20.56646283
Randy Foye,200751,2014-15,119,32,20,12,58,60,34,19,41,2188,19.40657578
Will Barton,203115,2014-15,81,25,14,11,31,61,21,22,39,1960,20.15024304
JJ Hickson,201581,2014-15,57,26,16,10,18,96,25,53,43,2802,20.07446478
Danilo Gallinari,201568,2014-15,83,25,20,5,42,57,28,21,36,2846,21.80474284
Erick Green,203475,2014-15,39,10,8,2,15,14,3,9,5,818,18.56410256
Gary Harris,203914,2014-15,29,7,6,1,12,38,9,23,15,1469,16.31205674
Ian Clark,203546,2014-15,12,6,2,4,5,9,5,2,7,375,15.63218391
Wilson Chandler,201163,2014-15,134,54,38,16,50,110,35,54,56,4917,20.11959198
Jamaal Franklin,203479,2014-15,3,1,0,1,2,3,1,2,1,31,13.51351351
Jusuf Nurkic,203994,2014-15,50,15,13,2,27,86,16,52,34,2213,20.74882995
Jameer Nelson,2749,2014-15,253,73,51,22,110,109,44,44,65,2768,19.8482933
Kenneth Faried,202702,2014-15,89,26,23,3,44,118,35,59,59,4147,20.29015544
Joffrey Lauvergne,203530,2014-15,13,5,5,0,3,22,8,9,13,537,19.0625
Andre Drummond,203083,2014-15,55,17,13,4,29,120,18,80,40,4827,22.05700124
Reggie Jackson,202704,2014-15,462,131,85,46,190,186,81,68,118,4389,24.97059976
Shawne Williams,200761,2014-15,44,15,9,6,12,30,10,17,13,2028,15.28021016
Kentavious Caldwell-Pope,203484,2014-15,109,35,25,10,46,94,26,41,53,5023,19.33833561
Brandon Jennings,201943,2014-15,272,73,47,26,120,90,48,26,64,2316,25.43182653
Spencer Dinwiddie,203915,2014-15,104,36,27,9,39,33,13,17,16,863,21.54915591
John Lucas III,101249,2014-15,60,17,10,7,10,16,8,4,12,516,21.18055556
Greg Monroe,202328,2014-15,142,52,38,14,64,149,33,65,84,4096,23.96591145
Jodie Meeks,201975,2014-15,79,21,11,10,32,57,18,22,35,2845,20.05486132
Tayshaun Prince,2419,2014-15,93,22,17,5,38,35,10,17,18,2628,15.40237467
Caron Butler,2406,2014-15,79,26,14,12,30,49,25,21,28,3095,13.21499014
Quincy Miller,203113,2014-15,8,3,3,0,4,5,1,2,3,245,16.66666667
Cartier Martin,201858,2014-15,11,6,3,3,4,5,0,4,1,379,12.80353201
Anthony Tolliver,201229,2014-15,59,16,13,3,27,51,17,32,19,2803,14.79974969
Joel Anthony,201202,2014-15,5,3,2,1,1,12,1,10,2,774,9.464082098
Ognjen Kuzmic,203136,2014-15,6,3,3,0,2,5,3,2,3,155,11.17647059
Brandon Rush,201575,2014-15,12,4,3,1,5,11,4,5,6,572,10.95461659
Marreese Speights,201578,2014-15,72,16,12,4,33,82,16,48,34,2490,28.96995708
Justin Holiday,203200,2014-15,48,12,10,2,22,29,16,8,21,1333,18.84538819
Andre Iguodala,2738,2014-15,228,71,46,25,95,88,41,34,54,4174,13.45091373
David Lee,101135,2014-15,85,36,28,8,26,49,14,21,28,1821,19.80676329
Klay Thompson,202691,2014-15,222,61,41,20,108,149,55,52,97,5060,27.53444013
Andrew Bogut,101106,2014-15,180,65,48,17,66,106,34,56,50,3212,13.29802063
Leandro Barbosa,2571,2014-15,99,33,23,10,37,44,16,14,30,1981,20.62222222
James Michael McAdoo,203949,2014-15,2,0,0,0,1,6,2,1,5,281,19.04761905
Draymond Green,203110,2014-15,291,116,76,40,109,133,51,59,74,5139,17.12995136
Stephen Curry,201939,2014-15,619,184,115,69,281,249,125,82,167,5447,28.14439726
Festus Ezeli,203105,2014-15,9,6,6,0,1,32,3,19,13,1009,17.88478074
Shaun Livingston,2733,2014-15,259,74,57,17,94,102,36,46,56,2921,16.3630844
Harrison Barnes,203084,2014-15,116,45,36,9,38,71,21,29,42,4750,14.96329757
Trevor Ariza,2772,2014-15,209,92,48,44,80,141,51,70,71,5838,16.62938106
Patrick Beverley,201976,2014-15,192,75,54,21,76,83,42,33,50,3440,16.29142423
Nick Johnson,203910,2014-15,11,3,2,1,8,19,6,12,7,530,17.43421053
Josh Smith,2746,2014-15,277,119,54,65,136,206,76,91,115,4625,24.73584906
Terrence Jones,203093,2014-15,36,18,11,7,13,37,6,20,17,1774,18.87450199
Joey Dorsey,201595,2014-15,25,9,6,3,13,41,8,29,12,1727,11.13300493
Pablo Prigioni,203143,2014-15,171,55,43,12,60,62,38,18,44,2324,11.70454545
Dwight Howard,2730,2014-15,50,26,20,6,17,115,20,69,46,2429,23.59268555
James Harden,201935,2014-15,565,250,119,131,246,321,130,119,202,5971,31.28825415
Clint Capela,203991,2014-15,2,1,1,0,1,5,3,1,4,189,21.32701422
Kostas Papanikolaou,203123,2014-15,85,35,23,12,42,55,29,12,43,1585,14.40443213
Donatas Motiejunas,202700,2014-15,130,56,38,18,53,123,36,64,59,4024,19.39106025
Jason Terry,1891,2014-15,147,51,32,19,71,74,35,27,47,3328,14.04199475
KJ McDaniels,203909,2014-15,72,21,15,6,32,105,34,47,58,2685,19.37984496
Corey Brewer,201147,2014-15,173,50,36,14,81,130,47,56,74,4302,21.02169065
CJ Miles,101139,2014-15,75,20,14,6,28,73,33,29,44,3627,23.49368319
Rodney Stuckey,201155,2014-15,219,68,37,31,56,118,48,49,69,3620,23.40787555
George Hill,201588,2014-15,220,59,41,18,40,69,30,26,43,2438,24.35100548
Luis Scola,2449,2014-15,105,38,29,9,37,94,32,36,58,3239,22.6681128
Lavoy Allen,202730,2014-15,73,23,18,5,29,40,13,18,22,2049,15.12992456
Damjan Rudez,204014,2014-15,53,24,14,10,16,47,20,24,23,2047,13.73224279
Paul George,202331,2014-15,6,1,0,1,0,12,2,8,4,173,32.67326733
Donald Sloan,202388,2014-15,190,58,39,19,32,65,28,20,45,2132,18.53817885
David West,2561,2014-15,223,64,36,28,83,120,45,54,66,3690,21.13352546
Chris Copeland,203142,2014-15,51,15,11,4,14,59,19,26,33,1597,21.12753147
Ian Mahinmi,101133,2014-15,33,12,9,3,10,59,10,42,17,2192,12.50996016
C.J. Watson,201228,2014-15,208,52,38,14,51,100,42,39,61,2793,18.54660348
Shayne Whittington,203963,2014-15,6,2,1,1,4,5,0,4,1,211,24.68085106
Solomon Hill,203524,2014-15,184,59,40,19,45,115,52,44,71,4556,16.19433198
Roy Hibbert,201579,2014-15,84,22,15,7,45,107,24,54,53,3654,22.01879065
Glen Davis,201175,2014-15,39,17,12,5,8,39,6,26,13,1758,17.40473738
Jordan Hamilton,202706,2014-15,7,2,1,1,1,4,3,1,3,245,14.44444444
Chris Paul,101108,2014-15,838,232,156,76,328,190,88,71,119,5649,23.50827866
JJ Redick,200755,2014-15,137,43,29,14,66,95,33,44,51,4780,20.39948215
DeAndre Jordan,201599,2014-15,61,22,18,4,19,109,23,61,48,5509,13.63925056
Spencer Hawes,201150,2014-15,88,39,29,10,24,61,14,34,27,2468,18.70397644
Jamal Crawford,2037,2014-15,158,52,35,17,73,92,36,33,59,3358,27.63509898
Ekpe Udoh,202327,2014-15,8,5,5,0,2,7,2,3,4,261,12.36749117
Lester Hudson,201991,2014-15,5,3,3,0,1,3,3,0,3,106,16.37931034
Hedo Turkoglu,2045,2014-15,37,21,11,10,5,29,11,11,18,1379,14.69225678
Matt Barnes,2440,2014-15,114,35,26,9,50,87,36,40,47,4473,14.83009232
Austin Rivers,203085,2014-15,155,56,41,15,56,65,27,21,44,3015,17.9889567
CJ Wilcox,203912,2014-15,8,3,3,0,2,10,5,2,8,208,21.14537445
Dahntay Jones,2563,2014-15,2,1,1,0,1,1,0,1,0,244,9.854014599
Blake Griffin,201933,2014-15,354,144,89,55,116,152,47,62,90,4646,28.26169646
Nick Young,201156,2014-15,41,7,6,1,19,44,11,16,28,1976,25.45374059
Wayne Ellington,201961,2014-15,105,23,16,7,44,50,20,16,34,3261,18.61088764
Ryan Kelly,203527,2014-15,92,29,20,9,28,37,12,15,22,2369,14.27514793
Carlos Boozer,2430,2014-15,95,20,16,4,33,92,21,50,42,3335,23.60965373
Jordan Clarkson,203903,2014-15,206,42,30,12,94,96,30,34,62,2842,23.41927563
Ronnie Price,101179,2014-15,165,36,23,13,57,52,23,15,37,1920,13.47291761
Wesley Johnson,202325,2014-15,124,25,19,6,50,87,33,37,50,4426,16.33986928
Vander Blue,203505,2014-15,8,2,1,1,3,6,3,3,3,152,20.32085561
Jabari Brown,203913,2014-15,40,14,11,3,12,32,11,10,22,1113,18.70615744
Jeremy Lin,202391,2014-15,339,55,35,20,165,166,69,55,111,3777,21.96478221
Ed Davis,202334,2014-15,94,30,24,6,31,58,10,28,30,3575,14.73149492
Kobe Bryant,977,2014-15,197,47,29,18,87,128,50,54,74,2402,34.18181818
Jordan Hill,201941,2014-15,103,28,24,4,33,106,23,46,60,3697,22.64685067
Tarik Black,204028,2014-15,42,15,13,2,10,48,5,33,15,2287,14.18332705
Julius Randle,203944,2014-15,0,0,0,0,0,1,1,0,1,24,17.85714286
Robert Sacre,203135,2014-15,55,21,20,1,10,36,10,20,16,2201,15.25559105
JaMychal Green,203210,2014-15,4,1,0,1,3,14,4,10,4,328,17.27748691
Jarnell Stokes,203950,2014-15,4,0,0,0,4,7,1,4,3,254,19.06354515
Russ Smith,203893,2014-15,8,3,3,0,4,12,3,8,4,136,25.74850299
Jordan Adams,203919,2014-15,16,1,1,0,9,14,4,6,8,486,19.23076923
Courtney Lee,201584,2014-15,151,34,25,9,45,78,32,35,43,4503,15.08357915
Tony Allen,2754,2014-15,86,14,7,7,47,86,27,36,50,3150,16.60639777
Mike Conley,201144,2014-15,375,54,29,25,162,156,83,43,113,4250,23.68911917
Nick Calathes,201979,2014-15,146,26,21,5,64,61,35,22,39,1597,17.64705882
Vince Carter,1713,2014-15,79,11,7,4,40,42,18,21,21,2109,19.87447699
Beno Udrih,2757,2014-15,220,57,39,18,82,89,46,24,65,2854,19.67871486
Jon Leuer,202720,2014-15,46,9,6,3,19,35,20,9,26,1577,18.76046901
Jeff Green,201145,2014-15,134,35,20,15,44,108,28,59,49,4791,22.18940373
Marc Gasol,201188,2014-15,307,73,45,28,155,176,50,86,90,5129,24.88352028
Kosta Koufos,201585,2014-15,37,8,4,4,8,69,10,43,26,2554,15.90057882
Zach Randolph,2216,2014-15,153,45,39,6,58,156,43,80,76,4392,24.36102236
Chris Bosh,2547,2014-15,95,23,15,8,35,95,19,42,53,2911,28.90120037
Dwyane Wade,2548,2014-15,299,91,53,38,143,209,83,79,130,3734,34.53596012
Josh McRoberts,201177,2014-15,33,4,4,0,19,22,10,9,13,542,13.32236842
Henry Walker,201611,2014-15,29,6,3,3,14,24,5,17,7,1215,14.54545455
Goran Dragic,201609,2014-15,350,112,69,43,146,173,78,60,113,5261,21.45020188
Tyler Johnson,204020,2014-15,42,14,9,5,16,30,7,11,19,1183,16.64145234
Luol Deng,2736,2014-15,139,43,28,15,52,108,43,37,71,4577,19.59798995
Chris Andersen,2365,2014-15,43,6,4,2,23,40,14,17,23,2129,12.72189349
Zoran Dragic,204054,2014-15,5,1,0,1,4,5,2,3,2,154,21.14285714
Shabazz Napier,203894,2014-15,130,48,27,21,40,81,38,31,50,1873,15.87901701
Mario Chalmers,201596,2014-15,307,97,56,41,131,173,64,79,94,4494,18.82050267
Hassan Whiteside,202355,2014-15,6,2,2,0,3,58,13,37,21,2171,20.53750501
Michael Beasley,201563,2014-15,32,10,7,3,16,37,16,16,21,975,24.20856611
James Ennis III,203516,2014-15,48,18,11,7,20,39,15,18,21,1967,14.64285714
Udonis Haslem,2617,2014-15,46,13,9,4,20,41,15,20,21,1862,14.50023463
O.J. Mayo,201564,2014-15,197,35,19,16,112,128,44,65,63,3363,23.59042553
Johnny O'Bryant III,203948,2014-15,17,6,1,5,4,25,4,14,11,713,19.30693069
Michael Carter-Williams,203487,2014-15,442,135,113,22,170,253,107,77,176,4240,26.93658335
Ersan Ilyasova,101141,2014-15,56,20,14,6,22,45,13,22,23,2583,21.99730094
Jared Dudley,201162,2014-15,130,43,22,21,51,62,28,29,33,3332,13.77101681
Tyler Ennis,203898,2014-15,73,22,16,6,26,42,25,10,32,818,20.25723473
Jabari Parker,203953,2014-15,42,10,5,5,24,47,14,17,30,1464,20.55622733
Jorge Gutierrez,203268,2014-15,22,2,1,1,10,12,4,8,4,342,14.94845361
Jerryd Bayless,201573,2014-15,233,68,46,22,79,133,55,57,76,3313,18.87346503
Miles Plumlee,203101,2014-15,34,14,11,3,7,51,15,27,24,2346,12.31174699
Khris Middleton,203114,2014-15,182,39,23,16,88,113,45,43,70,4647,19.75821685
Zaza Pachulia,2585,2014-15,178,35,25,10,86,133,39,61,72,3382,18.99585921
John Henson,203089,2014-15,59,15,7,8,27,87,20,48,39,2361,18.49775785
Giannis Antetokounmpo,203507,2014-15,207,73,43,30,81,173,37,105,68,4940,19.70128023
Adreian Payne,203940,2014-15,30,6,4,2,9,44,9,25,19,1417,17.73093614
Robbie Hummel,203133,2014-15,27,9,7,2,12,18,10,6,12,1438,12.28175798
Gorgui Dieng,203476,2014-15,146,31,26,5,61,126,28,67,59,4295,15.16990291
Lorenzo Brown,203485,2014-15,90,29,17,12,25,30,11,13,17,1045,13.63251482
Zach LaVine,203897,2014-15,276,40,31,9,99,193,89,59,134,3727,22.33238905
Ricky Rubio,201937,2014-15,193,31,22,9,78,64,36,18,46,1382,19.6762142
Chase Budinger,201978,2014-15,64,12,12,0,28,49,22,19,30,2543,16.45127489
Gary Neal,202390,2014-15,100,35,27,8,26,65,26,30,35,2319,23.79679144
Nikola Pekovic,201593,2014-15,27,4,3,1,13,41,7,24,17,1593,22.85867238
Shabazz Muhammad,203498,2014-15,44,8,6,2,18,35,11,16,19,1720,24.47968285
Kevin Garnett,708,2014-15,77,22,18,4,35,46,16,26,20,1813,18.37944664
Andrew Wiggins,203952,2014-15,170,40,29,11,72,177,47,79,98,5805,22.7374385
Kevin Martin,2755,2014-15,89,12,10,2,33,76,26,33,43,2585,26.55137335
Anthony Bennett,203461,2014-15,48,13,10,3,22,36,7,20,16,1781,17.69005848
Justin Hamilton,203120,2014-15,36,10,6,4,10,26,9,10,16,1366,14.70588235
Arinze Onuaku,202620,2014-15,4,2,1,1,1,2,0,2,0,133,12.82051282
Tyreke Evans,201936,2014-15,521,184,128,56,195,246,94,103,143,5131,25.82159624
Omer Asik,201600,2014-15,72,24,17,7,23,95,15,59,36,3731,14.06141769
Jeff Withey,203481,2014-15,11,5,4,1,2,12,2,6,6,495,17.79359431
Luke Babbitt,202337,2014-15,24,8,8,0,9,26,12,6,20,1608,12.54836926
Eric Gordon,201569,2014-15,229,47,26,21,101,122,46,46,76,3829,19.83677171
Jrue Holiday,201950,2014-15,274,55,38,17,136,91,43,30,61,2538,22.64736298
Toney Douglas,201962,2014-15,24,7,4,3,11,10,5,4,6,328,18.45730028
Quincy Pondexter,202347,2014-15,94,16,11,5,50,51,17,25,26,3396,13.85604113
Anthony Davis,203076,2014-15,149,56,39,17,66,95,15,58,37,4708,27.52310536
Norris Cole,202708,2014-15,255,80,57,23,79,99,38,47,52,3394,18.37652036
Jimmer Fredette,202690,2014-15,58,16,15,1,28,33,10,12,21,996,18.73373807
Ryan Anderson,201583,2014-15,55,16,12,4,21,62,12,31,31,3207,23.02507414
Alexis Ajinca,201582,2014-15,47,6,5,1,20,69,11,39,30,1794,21.50485437
Dante Cunningham,201967,2014-15,50,13,11,2,21,35,10,20,15,3073,11.23085649
Shane Larkin,203499,2014-15,226,66,52,14,61,83,46,19,64,3496,13.77155711
Alexey Shved,203144,2014-15,106,22,16,6,40,48,23,15,33,1516,25.89182969
Langston Galloway,204038,2014-15,150,41,30,11,38,61,30,23,38,2788,19.05511811
Jose Calderon,101181,2014-15,198,50,36,14,55,75,54,11,64,2428,16.01590745
Quincy Acy,203112,2014-15,68,22,19,3,18,60,19,23,37,2437,15.51662496
Tim Hardaway Jr.,203501,2014-15,127,23,17,6,46,82,28,30,52,3206,23.55992356
Travis Wear,204037,2014-15,40,14,14,0,14,35,14,12,23,1261,17.91462561
Carmelo Anthony,2546,2014-15,122,40,31,9,39,89,23,52,37,2691,32.32421875
Ricky Ledo,203495,2014-15,19,7,4,3,7,26,12,8,18,475,24.04371585
Jason Smith,201160,2014-15,140,46,38,8,39,104,31,52,52,3400,19.86566779
Cleanthony Early,203921,2014-15,36,12,9,3,6,40,18,17,23,1248,19.67213115
Lou Amundson,200811,2014-15,70,11,9,2,18,62,17,34,28,1784,17.71400297
Lance Thomas,202498,2014-15,69,25,21,4,13,74,21,40,34,2830,17.29346486
Cole Aldrich,202332,2014-15,75,14,9,5,31,59,24,29,30,1859,18.2932579
Andrea Bargnani,200745,2014-15,46,7,6,1,19,42,12,16,26,1510,26.35885447
Russell Westbrook,201566,2014-15,574,147,93,54,259,293,130,101,192,4708,37.25703906
Anthony Morrow,201627,2014-15,60,19,11,8,27,38,10,19,19,3643,16.31003329
Perry Jones III,203103,2014-15,18,9,5,4,5,24,6,13,11,1250,15.59440559
Nick Collison,2555,2014-15,90,26,17,9,41,45,17,24,21,2165,13.06089744
Kyle Singler,202713,2014-15,85,28,17,11,29,55,22,21,34,3413,13.13485114
Steve Novak,200779,2014-15,11,5,5,0,4,5,2,2,3,407,13.19148936
Serge Ibaka,201586,2014-15,55,23,16,7,23,97,16,60,37,4175,19.31205968
Jeremy Lamb,203087,2014-15,44,12,9,3,15,27,13,10,17,1218,21.67630058
Steven Adams,203500,2014-15,66,27,20,7,14,99,19,56,43,3475,14.50700762
D.J. Augustin,201571,2014-15,353,121,84,37,137,145,68,51,94,3829,19.81110861
Andre Roberson,203460,2014-15,70,25,18,7,20,46,20,20,26,2558,9.027081244
Dion Waiters,203079,2014-15,163,62,37,25,58,113,40,47,66,4405,22.22657014
Mitch McGary,203956,2014-15,14,6,4,2,7,31,7,14,17,990,18.55400697
Enes Kanter,202683,2014-15,55,22,13,9,16,145,26,83,62,4140,24.20618557
Kevin Durant,201142,2014-15,110,30,17,13,47,74,34,20,54,1856,28.34572491
Aaron Gordon,203932,2014-15,33,14,9,5,14,38,10,21,17,1527,15.63218391
Kyle O'Quinn,203124,2014-15,59,11,8,3,33,55,23,29,26,1580,18.53770869
Dewayne Dedmon,203473,2014-15,9,1,1,0,6,51,9,32,19,1616,12.89978678
Elfrid Payton,203901,2014-15,533,136,89,47,202,203,93,80,123,4849,18.26748822
Victor Oladipo,203506,2014-15,295,83,52,31,98,204,70,79,125,5028,25.31244499
Ben Gordon,2732,2014-15,50,8,7,1,23,55,20,24,31,1529,22.10587551
Channing Frye,101112,2014-15,94,22,13,9,44,78,24,48,30,3660,14.09756098
Nikola Vucevic,202696,2014-15,147,63,44,19,60,148,31,85,63,4963,25.84730646
Evan Fournier,203095,2014-15,120,40,25,15,40,82,25,33,49,3221,20.07786429
Devyn Marble,203906,2014-15,17,5,3,2,8,9,6,3,6,434,12.44813278
Tobias Harris,202699,2014-15,124,32,21,11,54,115,28,59,56,4608,22.51157407
Luke Ridnour,2557,2014-15,96,28,22,6,32,38,18,10,28,1342,15.01683502
Maurice Harkless,203090,2014-15,25,5,3,2,15,27,11,11,16,1314,13.50632069
Willie Green,2584,2014-15,68,25,23,2,19,48,26,14,34,1840,17.83470275
Andrew Nicholson,203094,2014-15,22,8,6,2,5,24,9,12,12,939,21.44899905
Isaiah Canaan,203477,2014-15,98,44,28,16,35,62,23,31,31,1871,21.58139535
Glenn Robinson III,203922,2014-15,11,6,4,2,4,11,2,6,5,524,14.77832512
Nerlens Noel,203457,2014-15,128,47,40,7,55,146,40,68,78,4558,17.42146849
Ish Smith,202397,2014-15,180,65,47,18,84,78,29,27,51,1668,24.2768595
Tony Wroten,203100,2014-15,157,54,41,13,72,113,40,53,60,1777,30.61523438
JaKarr Sampson,203960,2014-15,77,25,19,6,30,76,21,35,41,2268,17.92997307
Luc Mbah a Moute,201601,2014-15,106,45,35,10,40,99,27,53,46,3745,18.92965646
Furkan Aldemir,203128,2014-15,28,13,13,0,9,17,4,8,9,1057,8.503937008
Jason Richardson,2202,2014-15,38,14,10,4,16,16,9,3,13,812,21.80451128
Hollis Thompson,203138,2014-15,85,26,18,8,28,66,26,31,35,3546,15.88162762
Robert Covington,203496,2014-15,105,34,24,10,43,128,35,59,69,3866,21.773113
Henry Sims,203156,2014-15,79,20,16,4,43,99,34,48,51,2765,20.59467919
Jerami Grant,203924,2014-15,79,29,22,7,34,85,29,38,47,2750,16.70357482
Thomas Robinson,203080,2014-15,33,12,10,2,14,59,10,37,22,1604,19.56289979
Eric Bledsoe,202339,2014-15,493,157,107,50,194,274,96,123,151,5609,23.78386943
Brandon Knight,202688,2014-15,330,68,38,30,135,189,85,71,118,4064,25.49402823
Jerel McNeal,202077,2014-15,2,0,0,0,0,5,3,0,5,73,21.25
Markieff Morris,202693,2014-15,192,63,33,30,90,170,65,84,86,5171,23.51629503
TJ Warren,203933,2014-15,25,10,8,2,8,27,7,16,11,1227,17.66809728
Gerald Green,101123,2014-15,91,35,19,16,37,104,26,53,51,2907,28.29268293
Marcus Morris,202694,2014-15,133,39,14,25,51,73,34,26,47,4097,19.18755402
PJ Tucker,200782,2014-15,122,36,26,10,52,96,29,58,38,4747,14.0289103
Archie Goodwin,203462,2014-15,44,9,6,3,23,48,20,17,31,1057,23.13311688
Alex Len,203458,2014-15,32,13,10,3,14,74,22,38,36,3070,13.56812933
Danny Granger,101122,2014-15,17,8,4,4,3,24,4,11,13,1128,16.07000796
Marcus Thornton,201977,2014-15,36,5,4,1,17,27,11,8,19,1431,23.54003612
Reggie Bullock,203493,2014-15,8,6,5,1,2,8,5,2,6,653,11.42061281
Earl Barron,2853,2014-15,5,2,1,1,1,5,1,3,2,278,15.67398119
Brandan Wright,201148,2014-15,41,16,14,2,11,34,6,14,20,2838,13.84998444
Damian Lillard,203081,2014-15,507,162,117,45,171,222,110,74,148,5739,26.59866017
Dorell Wright,2748,2014-15,41,16,8,8,11,18,11,4,14,1175,17.01966717
Wesley Matthews,202083,2014-15,139,54,40,14,32,81,32,32,49,3982,19.7353914
CJ McCollum,203468,2014-15,64,24,10,14,20,48,25,12,36,1922,20.45244691
Arron Afflalo,201167,2014-15,129,45,30,15,53,116,29,60,56,4919,19.03754627
Steve Blake,2581,2014-15,288,86,54,32,112,104,59,32,72,2990,13.28982498
Tim Frazier,204025,2014-15,60,27,18,9,17,25,9,10,15,484,17.33576642
Meyers Leonard,203086,2014-15,32,16,11,5,7,39,4,31,8,1662,16.05206074
LaMarcus Aldridge,200746,2014-15,124,60,45,15,40,122,26,54,68,4918,30.10657194
Joel Freeland,200777,2014-15,16,11,7,4,2,23,6,8,15,1201,13.50954479
Allen Crabbe,203459,2014-15,39,15,12,3,8,15,5,9,6,1356,11.48293963
Alonzo Gee,202087,2014-15,25,10,9,1,6,33,10,16,17,1339,16.76567657
Chris Kaman,2549,2014-15,65,34,22,12,15,108,26,40,68,2693,22.89826627
Robin Lopez,201577,2014-15,55,24,20,4,10,73,11,42,31,3160,15.67702553
Nicolas Batum,201587,2014-15,341,90,62,28,134,132,77,45,87,4676,14.54000375
Ray McCallum,203492,2014-15,188,34,19,15,90,85,31,38,47,2863,17.91629027
Ryan Hollins,200797,2014-15,14,1,1,0,6,25,5,13,12,870,13.50253807
Darren Collison,201954,2014-15,252,41,31,10,102,112,43,40,72,3135,21.03477523
Rudy Gay,200752,2014-15,250,62,30,32,116,183,58,76,107,4788,26.82882224
David Stockton,204065,2014-15,9,4,4,0,3,4,2,0,4,72,15.18987342
Nik Stauskas,203917,2014-15,67,10,6,4,28,40,16,13,27,2233,14.20233463
Derrick Williams,202682,2014-15,50,14,9,5,22,56,20,29,27,2920,18.94578313
DeMarcus Cousins,202326,2014-15,210,89,59,30,85,254,73,124,130,4015,34.02489627
Omri Casspi,201956,2014-15,102,21,11,10,52,88,26,37,51,2821,18.73638344
Andre Miller,1889,2014-15,284,59,44,15,126,104,57,32,72,2358,15.75868373
Ben McLemore,203463,2014-15,140,22,11,11,72,138,46,58,80,5306,17.25170521
Carl Landry,201171,2014-15,26,6,6,0,9,54,4,35,19,2331,18.40238895
Eric Moreland,203961,2014-15,0,0,0,0,0,0,0,0,0,5,20
Reggie Evans,2501,2014-15,32,7,5,2,15,45,11,23,22,1455,13.20645905
Jason Thompson,201574,2014-15,85,17,13,4,45,84,21,43,41,3903,13.11327154
Kyle Anderson,203937,2014-15,28,7,2,5,11,10,5,4,6,702,13.26530612
Kawhi Leonard,202695,2014-15,161,47,28,19,67,97,33,41,56,3972,23.09587814
Marco Belinelli,201158,2014-15,94,38,23,15,34,61,25,23,38,2702,18.97350993
Cory Joseph,202709,2014-15,188,72,58,14,51,67,20,27,40,2809,16.9924338
Patty Mills,201988,2014-15,87,33,22,11,30,35,12,13,22,1598,21.30697419
Tony Parker,2225,2014-15,335,118,72,46,117,146,51,59,87,3793,24.74616293
Jeff Ayres,201965,2014-15,14,3,2,1,8,26,9,13,13,759,15.66820276
Danny Green,201980,2014-15,158,36,22,14,69,93,38,42,51,4500,17.35340729
Matt Bonner,2588,2014-15,47,16,14,2,12,11,3,4,7,1834,12.51217137
Aron Baynes,203382,2014-15,35,14,12,2,12,65,15,31,34,2205,17.63285024
Manu Ginobili,1938,2014-15,293,89,58,31,140,154,79,48,106,3145,23.58757062
Tim Duncan,1495,2014-15,230,53,34,19,110,131,44,55,76,4342,22.42336968
Tiago Splitter,201168,2014-15,78,22,11,11,38,60,23,25,35,2007,18.41059603
Boris Diaw,2564,2014-15,233,72,42,30,85,126,43,58,68,3850,18.38895282
Reggie Williams,202130,2014-15,10,2,2,0,6,2,1,1,1,211,17.87234043
Landry Fields,202361,2014-15,15,5,3,2,5,8,3,3,5,427,10.8559499
James Johnson,201949,2014-15,95,35,15,20,41,79,18,41,38,2629,17.42876077
Bruno Caboclo,203998,2014-15,0,0,0,0,0,4,1,1,3,45,29.09090909
Kyle Lowry,200768,2014-15,473,134,87,47,200,173,67,69,104,4728,24.95849474
DeMar DeRozan,201942,2014-15,210,103,67,36,70,137,39,49,88,4056,28.59939104
Amir Johnson,101161,2014-15,117,25,18,7,51,110,25,65,45,3820,15.75813101
Jonas Valanciunas,202685,2014-15,39,17,11,6,16,109,14,61,48,4031,19.47540984
Greivis Vasquez,202349,2014-15,302,81,52,29,127,119,59,46,73,3815,20.05070293
Lou Williams,101150,2014-15,164,62,35,27,56,101,52,24,77,3937,26.42936596
Terrence Ross,203082,2014-15,86,28,18,10,32,69,20,24,45,4012,18.43368237
Greg Stiemsma,201880,2014-15,3,2,2,0,1,7,2,4,3,132,11.40939597
Chuck Hayes,101236,2014-15,20,7,6,1,7,8,3,2,6,490,10.70780399
Tyler Hansbrough,201946,2014-15,21,11,7,4,2,20,1,14,6,1999,10.90670171
Patrick Patterson,202335,2014-15,155,58,35,23,67,54,21,28,26,4169,13.02354657
Lucas Nogueira,203512,2014-15,1,0,0,0,1,2,0,2,0,50,19.04761905
Joe Ingles,204060,2014-15,182,51,23,28,102,98,48,34,64,3136,12.96654686
Trey Burke,203504,2014-15,328,83,57,26,156,124,66,36,88,4309,23.83616384
Rodney Hood,203918,2014-15,83,28,20,8,37,45,16,21,24,1979,19.73856209
Bryce Cotton,203955,2014-15,15,2,1,1,10,12,7,4,8,331,23.35958005
Alec Burks,202692,2014-15,82,24,18,6,38,52,27,18,34,1693,20.95531587
Dante Exum,203957,2014-15,198,63,42,21,104,118,72,31,87,3342,14.09827631
Elijah Millsap,202407,2014-15,58,21,14,7,27,67,21,31,36,1725,17.08766716
Derrick Favors,202324,2014-15,112,49,33,16,35,121,37,54,67,4251,24.26470588
Grant Jerrett,203511,2014-15,3,1,1,0,1,3,2,0,3,107,23.7704918
Gordon Hayward,202330,2014-15,313,117,74,43,133,206,75,87,119,4945,26.17883339
Chris Johnson,203187,2014-15,15,2,1,1,8,15,5,8,7,1056,14.37962202
Rudy Gobert,203497,2014-15,109,44,33,11,38,111,26,64,47,4030,14.15456874
Trevor Booker,202344,2014-15,83,38,28,10,31,88,25,42,46,2908,18.30778302
Jeremy Evans,202379,2014-15,13,8,8,0,3,5,1,3,2,499,12.95336788
Jack Cooley,204022,2014-15,1,0,0,0,0,3,0,3,0,182,16.35514019
Will Bynum,101198,2014-15,18,4,4,0,5,8,6,1,7,131,26.79738562
John Wall,202322,2014-15,792,208,136,72,339,304,145,101,203,5621,25.73506165
Bradley Beal,203078,2014-15,194,40,27,13,74,123,49,51,72,4100,22.60586319
Marcin Gortat,101162,2014-15,97,36,22,14,23,100,22,57,43,4828,17.56259205
Ramon Sessions,201196,2014-15,182,44,33,11,80,86,35,34,52,2276,19.19075145
Rasual Butler,2446,2014-15,63,6,4,2,25,48,16,20,28,2908,17.78644271
Martell Webster,101110,2014-15,17,0,0,0,7,22,11,3,19,696,18.04320203
Kevin Seraphin,202338,2014-15,59,12,10,2,24,98,12,62,36,2301,22.13363705
Garrett Temple,202066,2014-15,56,9,8,1,20,34,16,14,20,1447,13.87530562
Otto Porter Jr.,203490,2014-15,65,12,8,4,27,52,14,32,20,2730,15.21808341
Paul Pierce,1718,2014-15,144,21,18,3,72,92,34,42,50,3795,19.85398022
Nene ,2403,2014-15,123,26,17,9,56,124,30,71,53,3302,21.97891322
Kris Humphries,2743,2014-15,57,16,11,5,16,46,18,22,24,2568,18.50969718
DeJuan Blair,201971,2014-15,3,1,1,0,1,13,4,6,7,362,17.7184466
Drew Gooden,2400,2014-15,49,7,5,2,24,28,13,11,17,1654,17.1957672
Jeff Teague,201952,2013-14,528,169,124,45,180,232,97,80,152,5062,25.42882405
Lou Williams,101150,2013-14,210,53,39,14,79,92,40,36,56,2842,21.08280255
Paul Millsap,200794,2013-14,232,85,44,41,90,185,46,96,89,4905,25.56787207
DeMarre Carroll,201960,2013-14,134,52,30,22,49,79,27,34,45,4570,15.24795002
Pero Antic,203544,2013-14,58,20,16,4,21,55,13,32,23,1838,18.32208293
Shelvin Mack,202714,2013-14,271,96,67,29,91,89,39,32,57,2907,19.20345786
John Jenkins,203098,2013-14,11,5,4,1,2,11,4,4,7,310,16.07142857
Gustavo Ayon,202970,2013-14,28,9,7,2,12,29,6,17,12,835,14.96815287
Al Horford,201143,2013-14,76,29,19,10,29,64,14,42,22,1900,24.88129155
Dennis Schroder,203471,2013-14,93,24,15,9,36,61,30,26,35,1230,19.66250917
Cartier Martin,201858,2013-14,33,13,7,6,9,34,11,17,17,1695,17.27609963
Kyle Korver,2594,2013-14,208,51,34,17,82,102,51,29,73,4787,13.7607799
Mike Muscala,203488,2013-14,7,2,0,2,2,12,1,6,6,422,19.44444444
Mike Scott,203118,2013-14,75,30,19,11,24,79,21,36,43,2905,23.86008745
Elton Brand,1882,2013-14,74,30,21,9,21,60,15,28,32,2753,14.28101349
Avery Bradley,202340,2013-14,85,18,17,1,39,96,33,46,50,3629,23.40168878
Keith Bogans,2586,2013-14,3,1,1,0,0,1,0,1,0,107,5.511811024
Jared Sullinger,203096,2013-14,118,39,25,14,40,119,23,69,50,3992,23.8362069
Jeff Green,201145,2013-14,138,42,26,16,44,165,33,97,68,5490,23.5238396
Rajon Rondo,200765,2013-14,294,80,59,21,99,99,41,38,61,1954,20.97411145
Jerryd Bayless,201573,2013-14,194,56,43,13,57,82,39,30,52,3202,19.73509934
Chris Johnson,203187,2013-14,31,10,9,1,6,22,6,11,11,1537,14.07284768
Phil Pressey,203515,2013-14,241,55,45,10,114,87,44,28,59,2184,14.4338118
Brandon Bass,101138,2013-14,87,27,14,13,26,102,22,51,51,4380,18.69121473
Vitor Faverani,203543,2013-14,16,4,1,3,9,41,8,20,21,935,19.36090226
Kelly Olynyk,203482,2013-14,109,31,19,12,50,106,19,65,41,2770,20.64777328
Kris Humphries,2743,2013-14,67,24,16,8,20,64,21,35,29,2634,19.31484502
Gerald Wallace,2222,2013-14,143,44,19,25,54,97,40,40,57,2736,11.79438663
Joel Anthony,201202,2013-14,2,2,2,0,0,3,0,3,0,364,9.466019417
Chris Babb,203569,2013-14,3,0,0,0,1,3,2,1,2,260,11.0367893
Andray Blatche,101154,2013-14,112,55,37,18,40,110,20,62,48,3099,25.35940196
Mason Plumlee,203486,2013-14,60,21,18,3,20,77,20,32,45,2434,17.15650257
Kevin Garnett,708,2013-14,82,27,21,6,34,68,24,36,32,2072,19.45780498
Alan Anderson,101187,2013-14,81,29,14,15,28,62,25,28,34,3350,15.92424647
Joe Johnson,2207,2013-14,216,83,62,21,77,120,42,53,67,4875,22.46136865
Deron Williams,101114,2013-14,392,146,111,35,130,143,57,52,91,3941,21.81524994
Marcus Thornton,201977,2013-14,77,19,11,8,39,67,32,18,49,3349,19.67170401
Brook Lopez,201572,2013-14,16,9,5,4,4,28,4,16,12,1018,26.92982456
Marquis Teague,203104,2013-14,58,24,17,7,18,39,11,22,17,839,17.99379524
Jorge Gutierrez,203268,2013-14,30,10,6,4,11,14,4,8,6,469,14.14913958
Shaun Livingston,2733,2013-14,245,89,64,25,101,105,31,55,50,3704,16.38472692
Mirza Teletovic,203141,2013-14,57,20,8,12,25,54,16,25,29,2687,20.19262703
Paul Pierce,1718,2013-14,178,65,39,26,60,153,51,74,79,3994,22.54635911
Andrei Kirilenko,1905,2013-14,72,12,10,2,44,54,23,26,28,1625,14.52574526
Jason Collins,2215,2013-14,4,1,1,0,2,7,1,5,2,343,8.823529412
Bismack Biyombo,202687,2013-14,8,2,1,1,2,40,2,27,13,2027,9.630266552
Jannero Pargo,2457,2013-14,52,23,17,6,18,26,11,10,16,470,27.97731569
DJ White,201591,2013-14,0,0,0,0,0,0,0,0,0,22,3.703703704
Gerald Henderson,201945,2013-14,199,48,37,11,80,113,31,60,53,4676,22.45714286
Josh McRoberts,201177,2013-14,333,63,41,22,140,83,29,40,43,4448,13.85979049
Gary Neal,202390,2013-14,83,22,16,6,33,64,23,30,34,2132,24.10491257
Luke Ridnour,2557,2013-14,176,46,38,8,73,66,39,20,46,2157,16.5779779
Michael Kidd-Gilchrist,203077,2013-14,52,11,10,1,19,60,13,35,25,2809,15.5632256
Kemba Walker,202689,2013-14,447,104,81,23,153,169,65,55,114,4999,25.8983891
Al Jefferson,2744,2013-14,155,50,40,10,66,124,20,61,63,4893,29.73370064
Cody Zeller,203469,2013-14,92,24,12,12,35,87,30,44,43,2774,18.35642317
Anthony Tolliver,201229,2013-14,42,16,11,5,13,23,10,12,11,2535,12.12653779
Jeffery Taylor,203106,2013-14,22,5,3,2,9,25,8,10,15,1226,18.83439943
Chris Douglas-Roberts,201604,2013-14,51,16,13,3,13,36,6,19,17,1955,14.68978102
Derrick Rose,201565,2013-14,43,9,6,3,20,34,9,12,22,605,29.4036061
Carlos Boozer,2430,2013-14,118,36,30,6,49,154,39,79,75,4077,26.08881298
Mike James,2229,2013-14,17,2,2,0,7,5,3,1,4,133,17.41935484
Greg Smith,202962,2013-14,0,0,0,0,0,5,0,5,0,204,14.89361702
Ronnie Brewer,200758,2013-14,10,6,3,3,2,2,2,0,2,322,5.217391304
Kirk Hinrich,2550,2013-14,286,70,48,22,84,120,56,44,76,3967,17.42076503
Joakim Noah,201149,2013-14,431,92,71,21,192,194,70,92,102,5263,18.7971157
D.J. Augustin,201571,2013-14,313,73,48,25,112,125,55,48,77,3605,22.5681873
Lou Amundson,200811,2013-14,6,4,3,1,1,14,2,10,4,344,14.25061425
Tony Snell,203503,2013-14,68,10,9,1,24,44,17,17,27,2291,15.09290861
Jimmy Butler,202710,2013-14,175,44,28,16,65,102,36,47,55,4826,17.0613563
Taj Gibson,201959,2013-14,91,39,29,10,33,150,28,91,59,4344,23.35257814
Jimmer Fredette,202690,2013-14,64,12,7,5,29,48,16,16,32,1009,24.3567753
Mike Dunleavy,2399,2013-14,186,31,18,13,78,108,58,38,70,4854,16.91977845
Nazr Mohammed,1737,2013-14,20,6,5,1,7,37,9,20,17,1020,14.83979764
CJ Miles,101139,2013-14,52,17,11,6,16,44,17,20,24,1910,21.80755396
Jarrett Jack,101127,2013-14,324,102,70,32,102,133,49,56,77,4319,18.01692866
Kyrie Irving,202681,2013-14,433,99,72,27,141,190,67,81,109,4830,27.85918513
Dion Waiters,203079,2013-14,209,68,40,28,67,154,47,73,81,4004,26.91645134
Matthew Dellavedova,203521,2013-14,187,48,35,13,78,60,32,19,41,2451,13.20754717
Luol Deng,2736,2013-14,183,44,23,21,72,114,41,50,64,4219,22.34933606
Sergey Karasev,203508,2013-14,6,0,0,0,3,11,8,3,8,316,14.52991453
Tristan Thompson,202684,2013-14,72,26,16,10,24,108,20,66,42,4967,17.73356401
Anthony Bennett,203461,2013-14,17,3,3,0,7,47,9,31,16,1310,19.97380485
Anderson Varejao,2760,2013-14,140,44,31,13,56,72,23,28,44,3418,14.80370093
Scotty Hopson,203816,2013-14,1,0,0,0,1,0,0,0,0,15,29.41176471
Carrick Felix,203467,2013-14,4,0,0,0,2,4,1,1,3,82,21.73913043
Spencer Hawes,201150,2013-14,240,42,30,12,130,173,74,72,101,5029,19.67069539
Alonzo Gee,202087,2013-14,47,13,9,4,10,44,17,18,26,1983,13.51114998
Tyler Zeller,203092,2013-14,36,12,10,2,10,60,5,41,19,2016,17.33905579
Tyson Chandler,2199,2013-14,59,22,21,1,9,71,16,44,27,3103,12.99323563
Raymond Felton,101109,2013-14,365,143,114,29,133,129,59,40,89,3801,18.36876155
Shawn Marion,1890,2013-14,124,52,37,15,36,95,44,34,61,4682,15.87664192
Bernard James,203108,2013-14,3,2,2,0,0,10,0,5,5,301,10.77844311
Ricky Ledo,203495,2013-14,2,1,1,0,0,2,1,1,1,68,28
Jae Crowder,203109,2013-14,60,20,16,4,23,41,13,20,21,2441,13.29437546
Monta Ellis,101145,2013-14,471,163,130,33,184,264,102,100,164,5929,26.14064147
Devin Harris,2734,2013-14,178,62,47,15,66,59,25,22,37,1590,20.18962632
Vince Carter,1713,2013-14,212,52,37,15,104,108,45,52,56,3889,22.99794661
Gal Mekel,203539,2013-14,63,25,22,3,21,31,13,15,16,593,18.14159292
Brandan Wright,201148,2013-14,31,16,15,1,6,35,4,16,19,2072,17.74817361
Dirk Nowitzki,1717,2013-14,216,58,34,24,105,117,42,35,82,5141,26.76031911
DeJuan Blair,201971,2013-14,70,28,22,6,24,77,22,39,38,2410,19.16299559
Aaron Brooks,201166,2013-14,233,80,43,37,101,117,54,38,79,3169,20.48092869
Darrell Arthur,201589,2013-14,61,17,9,8,27,58,20,31,27,2346,18.64661654
Ty Lawson,201951,2013-14,543,170,121,49,244,200,103,65,135,4580,22.69692924
Randy Foye,200751,2013-14,287,74,43,31,153,145,71,54,91,5113,18.51099831
JJ Hickson,201581,2013-14,96,40,26,14,42,128,16,85,43,3775,20.87811571
Nate Robinson,101126,2013-14,112,22,17,5,40,58,26,22,36,1701,24.37275986
Anthony Randolph,201576,2013-14,32,17,14,3,10,39,12,25,14,1080,20.19785655
Wilson Chandler,201163,2013-14,114,38,34,4,47,79,27,40,39,3941,19.57098629
Jan Vesely,202686,2013-14,21,5,3,2,12,36,6,25,11,1509,13.37507114
Timofey Mozgov,202389,2013-14,62,26,18,8,21,122,18,79,43,3595,19.04531136
Quincy Miller,203113,2013-14,26,10,8,2,9,48,14,17,31,1629,17.39820201
JaVale McGee,201580,2013-14,2,0,0,0,2,8,2,4,4,162,24.7311828
Kenneth Faried,202702,2013-14,96,42,24,18,46,134,49,55,79,4440,21.31147541
Evan Fournier,203095,2013-14,112,30,19,11,44,100,34,44,56,3113,19.49790795
Andre Drummond,203083,2013-14,35,9,7,2,19,110,16,72,38,5112,16.94664032
Chauncey Billups,1497,2013-14,42,10,8,2,19,25,7,11,14,603,15.4494382
Rodney Stuckey,201155,2013-14,152,34,22,12,78,125,46,49,76,3821,24.46284691
Kentavious Caldwell-Pope,203484,2013-14,55,16,10,6,25,28,9,14,14,3136,13.86861314
Josh Smith,2746,2013-14,252,70,32,38,146,199,76,68,131,5403,24.49364107
Brandon Jennings,201943,2013-14,609,104,64,40,344,215,106,60,155,5430,23.17549617
Tony Mitchell,203502,2013-14,2,1,1,0,1,4,1,3,1,158,12.95336788
Greg Monroe,202328,2013-14,171,46,31,15,91,166,41,71,95,5310,21.39216311
Will Bynum,101198,2013-14,216,47,23,24,115,103,42,36,67,2089,23.81729201
Gigi Datome,203540,2013-14,11,4,2,2,6,11,2,7,4,475,20.10676157
Kyle Singler,202713,2013-14,75,22,18,4,35,79,14,46,33,4614,14.05674282
Charlie Villanueva,101111,2013-14,6,3,1,2,3,7,2,3,4,349,25.36231884
Jonas Jerebko,201973,2013-14,39,11,7,4,19,43,16,18,25,1443,16.13278975
Peyton Siva,203491,2013-14,34,15,12,3,13,18,7,10,8,411,16.43286573
Josh Harrellson,202725,2013-14,15,3,2,1,9,10,4,5,5,631,12.87262873
Ognjen Kuzmic,203136,2013-14,2,2,1,1,0,10,4,5,5,200,12.38938053
Marreese Speights,201578,2013-14,32,12,9,3,12,66,14,34,32,1977,25.11091393
Jermaine O'Neal,979,2013-14,25,9,5,4,7,52,9,32,20,1724,18.56627127
Nemanja Nedovic,203517,2013-14,13,6,4,2,1,13,7,2,11,295,16.66666667
Andre Iguodala,2738,2013-14,263,100,64,36,96,100,41,42,58,4061,13.51410453
David Lee,101135,2013-14,147,57,32,25,57,152,39,71,81,4599,24.28598812
Klay Thompson,202691,2013-14,181,46,31,15,85,135,35,70,65,5737,22.74268105
Andrew Bogut,101106,2013-14,112,39,30,9,40,97,30,55,42,3542,12.5
Draymond Green,203110,2013-14,152,54,38,16,67,91,31,53,38,3591,15.00984252
Steve Blake,2581,2013-14,307,90,52,38,111,102,63,32,70,3023,13.96449704
Stephen Curry,201939,2013-14,666,154,102,52,329,294,149,97,197,5747,27.89765721
Harrison Barnes,203084,2013-14,116,43,30,13,48,84,17,46,38,4420,16.9498301
Jordan Crawford,202348,2013-14,281,86,51,35,100,134,43,60,74,3678,23.61244019
Hilton Armstrong,200756,2013-14,5,0,0,0,3,6,0,5,1,195,13.55932203
Isaiah Canaan,203477,2013-14,22,9,6,3,9,21,6,9,12,534,20.29950083
Patrick Beverley,201976,2013-14,151,59,43,16,72,66,26,30,36,3438,14.95823842
Omer Asik,201600,2013-14,25,12,11,1,8,59,11,40,19,1974,13.7254902
Jordan Hamilton,202706,2013-14,52,21,14,7,18,46,16,18,28,2058,18.76053963
Terrence Jones,203093,2013-14,87,34,27,7,47,71,23,27,44,4119,18.48685617
Jeremy Lin,202391,2013-14,294,102,73,29,150,176,78,62,114,4188,20.2192705
Dwight Howard,2730,2013-14,131,48,38,10,71,229,37,130,99,4755,24.34718647
James Harden,201935,2013-14,446,151,101,50,240,265,104,96,169,5598,27.42642455
Omri Casspi,201956,2013-14,88,34,25,9,40,72,22,33,39,2624,18.02675585
Donatas Motiejunas,202700,2013-14,34,25,20,5,6,49,12,25,24,1944,17.59890859
Josh Powell,2694,2013-14,0,0,0,0,0,1,0,1,0,37,17.07317073
Chandler Parsons,202718,2013-14,298,99,68,31,155,144,55,56,88,5574,19.40747782
Troy Daniels,203584,2013-14,5,3,1,2,0,3,1,2,1,145,20.1183432
Francisco Garcia,101128,2013-14,63,23,13,10,27,30,11,13,17,2193,13.4057971
Robert Covington,203496,2013-14,0,0,0,0,0,1,0,1,0,68,19.48051948
Lance Stephenson,202362,2013-14,359,91,54,37,123,210,84,88,122,5258,19.4668008
George Hill,201588,2013-14,265,57,37,20,63,92,39,42,50,4636,14.84567317
Luis Scola,2449,2013-14,81,31,23,8,28,108,29,53,55,2683,23.98560209
Lavoy Allen,202730,2013-14,71,26,24,2,27,43,14,22,21,2199,14.28015564
Rasual Butler,2446,2013-14,17,5,3,2,8,11,7,3,8,723,15.51515152
Solomon Hill,203524,2013-14,12,6,5,1,1,13,4,7,6,423,11.53846154
Evan Turner,202323,2013-14,262,72,58,14,128,189,69,67,122,4998,23.25008794
Donald Sloan,202388,2013-14,50,17,12,5,8,22,9,7,15,756,17.45283019
Andrew Bynum,101115,2013-14,29,6,4,2,13,34,6,25,9,1003,24.07566638
David West,2561,2013-14,223,72,50,22,90,133,43,72,61,4747,22.02855553
Chris Copeland,203142,2013-14,18,7,3,4,5,14,5,6,8,520,23.45890411
Paul George,202331,2013-14,283,64,43,21,92,224,87,97,127,5561,28.11016144
Ian Mahinmi,101133,2013-14,24,10,7,3,10,58,8,44,14,2392,11.48623853
C.J. Watson,201228,2013-14,107,32,19,13,18,60,17,36,24,2337,16.34651601
Roy Hibbert,201579,2013-14,91,24,22,2,52,148,19,96,52,4577,19.638392
Glen Davis,201175,2013-14,77,19,13,6,35,76,15,42,34,3205,20.44817927
Darren Collison,201954,2013-14,297,103,62,41,115,132,54,56,76,4061,19.84913793
Chris Paul,101108,2013-14,663,169,107,62,300,145,66,52,93,4388,23.3528108
JJ Redick,200755,2013-14,78,24,13,11,39,42,17,19,23,1983,21.36181575
DeAndre Jordan,201599,2013-14,74,18,14,4,35,123,30,76,47,5684,12.50578972
Hedo Turkoglu,2045,2013-14,33,8,4,4,14,16,6,7,9,760,15.61032864
Jared Dudley,201162,2013-14,104,37,23,14,42,56,23,27,29,3414,13.70217166
Jamal Crawford,2037,2013-14,223,50,26,24,106,135,51,53,82,4194,26.86787674
Ryan Hollins,200797,2013-14,8,2,1,1,5,29,5,21,8,950,11.96581197
Matt Barnes,2440,2013-14,125,31,19,12,70,85,42,31,54,3498,16.4321608
Reggie Bullock,203493,2013-14,12,3,2,1,5,13,5,6,7,795,15.43624161
Blake Griffin,201933,2013-14,309,95,50,45,139,224,61,120,104,5704,29.19119926
Danny Granger,101122,2013-14,41,15,8,7,14,46,17,18,28,1677,19.91657977
Willie Green,2584,2013-14,50,25,19,6,8,34,13,16,18,1724,16.68393782
Nick Young,201156,2013-14,95,27,20,7,33,95,31,36,59,3680,26.76262503
Jordan Farmar,200770,2013-14,199,80,53,27,61,95,51,30,65,1885,22.91271347
MarShon Brooks,202705,2013-14,25,8,5,3,11,24,6,11,13,664,23.05593452
Ryan Kelly,203527,2013-14,95,47,30,17,28,47,13,24,23,2729,15.83695289
Kent Bazemore,203145,2013-14,91,24,17,7,40,79,35,27,52,1907,22.39017478
Xavier Henry,202333,2013-14,51,13,10,3,23,57,14,26,31,1873,22.81116895
Chris Kaman,2549,2013-14,58,23,13,10,22,74,19,29,45,1527,26.4516129
Steve Nash,959,2013-14,86,28,20,8,27,31,14,12,19,656,18.75862069
Wesley Johnson,202325,2013-14,124,35,17,18,57,90,43,35,55,4633,15.11900117
Kendall Marshall,203088,2013-14,477,99,71,28,214,150,87,52,98,3233,16.36720943
Pau Gasol,2200,2013-14,201,83,68,15,65,141,55,30,111,3878,26.4835932
Jodie Meeks,201975,2013-14,138,49,35,14,50,111,45,32,79,5272,18.83538251
Kobe Bryant,977,2013-14,38,7,2,5,18,34,24,8,26,357,29.14572864
Jordan Hill,201941,2013-14,54,30,25,5,12,75,16,32,43,3008,19.71336648
Robert Sacre,203135,2013-14,51,33,28,5,7,44,8,25,19,2241,15.70850202
James Johnson,201949,2013-14,111,20,10,10,51,66,24,26,40,1804,19.77186312
Courtney Lee,201584,2013-14,115,22,15,7,34,73,34,33,40,3669,17.25118483
Tony Allen,2754,2013-14,94,14,8,6,45,90,28,40,50,2388,19.95692749
Mike Conley,201144,2013-14,441,78,49,29,172,150,71,40,110,4573,24.43524096
Nick Calathes,201979,2013-14,207,52,38,14,67,101,45,40,61,2195,17.70124149
Mike Miller,2034,2013-14,130,26,14,12,41,77,36,31,46,3245,14.3350146
Beno Udrih,2757,2013-14,116,31,19,12,39,47,21,15,32,1237,17.0212766
Quincy Pondexter,202347,2013-14,20,3,2,1,8,15,4,9,6,500,18.32460733
Tayshaun Prince,2419,2013-14,119,19,13,6,39,41,16,17,24,3583,13.69294606
Jamaal Franklin,203479,2013-14,6,3,2,1,1,11,5,6,5,311,14.12742382
Jon Leuer,202720,2013-14,20,4,4,0,8,27,11,10,17,1219,21.25360231
Ed Davis,202334,2013-14,27,5,4,1,12,40,4,29,11,1786,17.6217765
Marc Gasol,201188,2013-14,215,48,27,21,104,111,27,59,52,3645,22.39382239
Kosta Koufos,201585,2013-14,39,7,6,1,10,67,12,41,26,2510,19.23990499
Zach Randolph,2216,2013-14,200,48,43,5,88,183,54,88,95,5028,26.26712329
Toney Douglas,201962,2013-14,68,23,19,4,25,34,22,11,23,1284,16.55124654
Chris Bosh,2547,2013-14,87,32,16,16,36,124,39,49,75,4819,22.75142315
Dwyane Wade,2548,2013-14,252,70,39,31,134,161,63,62,99,3418,27.69726248
LeBron James,2544,2013-14,488,180,90,90,187,269,112,101,168,5549,30.84158416
Justin Hamilton,203120,2013-14,0,0,0,0,0,4,1,1,3,137,17.56756757
Michael Beasley,201563,2013-14,42,16,8,8,17,57,14,30,27,1584,25.456621
Rashard Lewis,1740,2013-14,57,25,16,9,17,35,17,15,20,1810,14.28571429
Chris Andersen,2365,2013-14,19,6,2,4,8,53,7,37,16,2600,13.98553221
Mario Chalmers,201596,2013-14,357,77,39,38,182,162,59,73,89,4194,17.2519084
Greg Oden,201141,2013-14,1,1,0,1,0,12,1,8,4,406,15.25054466
James Jones,2592,2013-14,9,3,2,1,2,4,1,2,2,430,16.34819533
Norris Cole,202708,2013-14,248,57,23,34,122,127,62,52,75,3767,15.75030012
Shane Battier,2203,2013-14,63,30,16,14,23,21,9,8,13,2795,9.990205681
Ray Allen,951,2013-14,143,57,25,32,61,84,31,34,50,3636,16.57142857
Udonis Haslem,2617,2013-14,13,6,4,2,5,24,7,14,10,1213,14.10447761
O.J. Mayo,201564,2013-14,113,22,13,9,54,95,45,35,60,2598,22.96795953
Ekpe Udoh,202327,2013-14,31,11,9,2,8,38,10,25,13,1498,11.85055458
Nate Wolters,203489,2013-14,187,65,50,15,60,57,32,17,40,2519,16.70668954
Ersan Ilyasova,101141,2013-14,72,24,16,8,24,61,22,32,29,2837,21.28111718
Larry Sanders,202336,2013-14,19,0,0,0,9,26,7,14,12,1110,16.53726708
Miroslav Raduljica,203545,2013-14,23,3,3,0,12,28,1,22,6,894,17.1950048
Brandon Knight,202688,2013-14,352,98,73,25,115,188,80,61,127,4595,26.79344756
Jeff Adrien,202399,2013-14,38,6,5,1,16,39,7,23,16,1860,16.80440771
Ramon Sessions,201196,2013-14,340,86,68,18,124,148,64,53,95,4283,22.41414347
Chris Wright,202874,2013-14,5,0,0,0,3,5,1,3,2,245,16.66666667
Khris Middleton,203114,2013-14,169,34,23,11,86,123,42,51,72,4713,19.01447151
Zaza Pachulia,2585,2013-14,136,20,15,5,66,92,23,46,46,2544,17.04584041
John Henson,203089,2013-14,113,37,33,4,47,114,25,64,50,3532,20.51093098
Giannis Antetokounmpo,203507,2013-14,150,37,28,9,67,122,32,65,57,3642,15.16090584
Othyus Jeffers,201785,2013-14,1,0,0,0,1,1,0,1,0,86,9.090909091
Alexey Shved,203144,2013-14,68,17,12,5,21,48,20,16,32,1307,21.20026093
Gorgui Dieng,203476,2013-14,39,11,8,3,17,54,7,38,16,1650,16.99895068
Robbie Hummel,203133,2013-14,23,6,4,2,7,10,4,5,5,1315,12.5566343
Ricky Rubio,201937,2013-14,704,182,132,50,338,221,140,57,164,5430,16.336
Chase Budinger,201978,2013-14,31,8,7,1,15,24,10,8,16,1477,17.28971963
J.J. Barea,200826,2013-14,303,65,46,19,122,125,54,50,75,2894,24.41412044
Luc Mbah a Moute,201601,2013-14,36,10,8,2,19,40,6,23,17,1933,11.53508772
Corey Brewer,201147,2013-14,135,40,34,6,74,105,34,43,62,5397,16.2327226
Nikola Pekovic,201593,2013-14,50,21,19,2,15,84,12,54,30,3391,22.66396556
Shabazz Muhammad,203498,2013-14,6,3,2,1,3,16,4,6,10,579,22.57597685
Kevin Martin,2755,2013-14,121,41,32,9,49,106,35,46,60,4496,24.73243822
Ronny Turiaf,101142,2013-14,24,11,10,1,5,24,8,12,12,1195,11.24173402
Dante Cunningham,201967,2013-14,83,32,26,6,32,42,11,19,23,3238,15.51216903
Kevin Love,201567,2013-14,341,57,39,18,191,196,73,81,115,5765,28.61018993
Al-Farouq Aminu,202329,2013-14,114,18,17,1,56,88,27,45,43,3895,14.33021807
Tyreke Evans,201936,2013-14,363,109,71,38,130,175,55,84,91,3883,27.31387192
Darius Miller,203121,2013-14,43,9,8,1,19,22,8,9,13,1380,12.87636131
Anthony Morrow,201627,2013-14,59,13,11,2,30,51,17,16,35,2721,19.17545542
Melvin Ely,2408,2013-14,0,0,0,0,0,0,0,0,0,46,11.76470588
Jeff Withey,203481,2013-14,26,6,4,2,13,20,3,11,9,1315,12.18206158
Luke Babbitt,202337,2013-14,29,10,7,3,14,15,4,6,9,889,17.71144279
Eric Gordon,201569,2013-14,208,28,18,10,78,134,38,51,83,4004,23.05671119
Jrue Holiday,201950,2013-14,268,68,53,15,124,105,46,38,67,2237,22.60802469
Jason Smith,201160,2013-14,29,7,4,3,7,28,6,17,11,1593,18.1372549
Brian Roberts,203148,2013-14,234,55,40,15,90,95,43,32,63,3204,20.20509978
Anthony Davis,203076,2013-14,105,28,21,7,36,109,20,64,45,4539,25.39713289
Austin Rivers,203085,2013-14,160,46,35,11,57,77,27,30,47,2522,21.63279366
James Southerland,203480,2013-14,0,0,0,0,0,1,1,0,1,59,24.28571429
Ryan Anderson,201583,2013-14,17,4,2,2,7,20,2,9,11,1548,21.89218922
Alexis Ajinca,201582,2013-14,40,8,6,2,18,63,13,35,28,1804,16.74008811
Samuel Dalembert,2223,2013-14,38,15,14,1,10,89,13,57,32,3128,15.07823613
Shane Larkin,203499,2013-14,71,23,18,5,16,39,15,17,22,954,17.09796673
Jose Calderon,101181,2013-14,377,97,65,32,132,103,56,31,72,4837,16.23773375
Wayne Ellington,201961,2013-14,19,7,4,3,7,11,5,2,9,800,15.49450549
Amar'e Stoudemire,2405,2013-14,34,17,16,1,7,91,8,65,26,2708,24.12781219
Kenyon Martin,2030,2013-14,50,10,9,1,19,26,8,16,10,1163,12.03351104
Jeremy Tyler,202719,2013-14,8,5,4,1,1,26,4,14,12,774,18.68629672
Tim Hardaway Jr.,203501,2013-14,66,23,15,8,26,47,13,20,27,3605,19.18746941
Carmelo Anthony,2546,2013-14,242,108,74,34,84,198,51,109,89,5615,32.27116526
JR Smith,2747,2013-14,219,89,56,33,76,108,33,42,66,4561,21.69793077
Pablo Prigioni,203143,2013-14,228,83,64,19,66,60,35,17,43,2351,9.595202399
Iman Shumpert,202697,2013-14,129,50,38,12,44,79,18,46,33,3635,14.32685385
Toure' Murry,203315,2013-14,49,12,12,0,26,34,12,16,18,747,21.36953955
Shannon Brown,200769,2013-14,9,2,2,0,2,18,4,11,7,501,16.8157424
Cole Aldrich,202332,2013-14,14,5,3,2,6,18,2,11,7,642,12.65306122
Andrea Bargnani,200745,2013-14,45,15,12,3,11,58,11,35,23,2361,22.37426036
Russell Westbrook,201566,2013-14,319,81,52,29,137,177,70,77,100,2894,33.36374696
Caron Butler,2406,2013-14,82,28,22,6,30,60,18,32,28,2769,20.32258065
Perry Jones III,203103,2013-14,26,7,6,1,8,21,6,9,12,1495,13.02816901
Nick Collison,2555,2013-14,104,32,30,2,45,71,22,35,36,2651,11.72778328
Kendrick Perkins,2570,2013-14,67,14,9,5,34,91,20,55,36,2381,11.74058889
Derek Fisher,965,2013-14,117,21,15,6,48,49,26,14,35,2803,13.91167192
Serge Ibaka,201586,2013-14,85,37,26,11,29,122,20,75,47,5333,19.74775971
Jeremy Lamb,203087,2013-14,115,35,31,4,41,61,20,21,40,3010,20.21461717
Steven Adams,203500,2013-14,43,11,11,0,13,71,9,42,29,2352,11.76255038
Reggie Jackson,202704,2013-14,331,93,58,35,109,168,58,73,95,4513,22.72993556
Andre Roberson,203460,2013-14,15,1,1,0,6,19,4,10,9,790,10.17699115
Thabo Sefolosha,200757,2013-14,94,16,11,5,40,55,17,26,29,3164,11.96413561
Hasheem Thabeet,201934,2013-14,1,0,0,0,1,14,2,8,6,393,9.198113208
Kevin Durant,201142,2013-14,445,114,68,46,188,285,98,96,189,6270,32.57682549
Doron Lamb,203117,2013-14,43,17,8,9,6,27,10,17,10,1328,13.37325349
Kyle O'Quinn,203124,2013-14,78,14,10,4,44,78,21,47,31,2320,18.66359447
Dewayne Dedmon,203473,2013-14,5,2,1,1,1,18,5,9,9,756,13.2032147
Arron Afflalo,201167,2013-14,248,75,56,19,84,146,40,75,71,4972,23.22036937
Victor Oladipo,203506,2013-14,327,74,50,24,114,256,85,102,154,4885,24.43794553
Nikola Vucevic,202696,2013-14,104,37,30,7,36,112,26,73,39,3542,21.73153693
Ronnie Price,101179,2013-14,66,11,7,4,19,26,13,7,19,722,15.38461538
Tobias Harris,202699,2013-14,82,27,13,14,28,78,12,43,35,3583,22.18379447
Jameer Nelson,2749,2013-14,476,113,62,51,161,166,62,66,100,4244,20.07108509
Maurice Harkless,203090,2013-14,80,19,12,7,32,86,18,52,34,3790,14.7957993
Andrew Nicholson,203094,2013-14,25,13,12,1,6,51,7,32,19,2276,19.5884448
Jason Maxiell,101131,2013-14,9,2,1,1,6,14,1,9,5,945,12.34911792
E'Twaun Moore,202734,2013-14,112,21,13,8,40,55,21,25,30,2954,16.26360339
Michael Carter-Williams,203487,2013-14,441,135,107,28,184,247,99,98,149,4978,25.67922875
Arnett Moultrie,203102,2013-14,2,0,0,0,1,7,1,5,2,396,10.32967033
Adonis Thomas,203519,2013-14,3,0,0,0,1,1,0,1,0,71,18.07228916
Tony Wroten,203100,2013-14,217,46,35,11,125,204,62,108,96,3642,27.68604929
James Anderson,202341,2013-14,149,55,41,14,60,106,34,47,59,4775,15.87708067
Casper Ware,203810,2013-14,10,1,0,1,4,5,3,2,3,236,19.30501931
Brandon Davies,203561,2013-14,28,8,6,2,13,35,10,19,16,1166,14.00749064
Thaddeus Young,201152,2013-14,182,43,32,11,105,165,46,70,95,5596,24.22535211
Elliot Williams,202343,2013-14,72,25,17,8,30,68,23,35,33,2386,16.78295997
Byron Mullens,201957,2013-14,14,8,6,2,3,27,6,13,14,834,21.21848739
Hollis Thompson,203138,2013-14,73,29,16,13,25,60,27,24,36,3543,11.33235005
Henry Sims,203156,2013-14,52,15,12,3,27,41,11,24,17,1739,18.44853307
Jarvis Varnado,202363,2013-14,13,8,8,0,2,10,3,5,5,689,12.23958333
Goran Dragic,201609,2013-14,447,196,131,65,148,213,71,88,125,5302,24.52830189
Eric Bledsoe,202339,2013-14,235,92,52,40,98,143,52,57,86,2841,24.89096573
Ish Smith,202397,2013-14,179,71,52,19,70,65,32,23,42,1995,15.82167832
Channing Frye,101112,2013-14,98,44,27,17,37,89,21,59,30,4589,17.47068999
Leandro Barbosa,2571,2013-14,32,16,11,5,6,19,4,10,9,724,19.97607656
Markieff Morris,202693,2013-14,144,58,33,25,66,147,37,76,71,4315,23.24159021
Gerald Green,101123,2013-14,122,45,26,19,46,145,42,72,73,4688,23.65286444
Marcus Morris,202694,2013-14,88,23,12,11,38,95,30,50,45,3581,20.16308377
PJ Tucker,200782,2013-14,141,54,38,16,53,102,29,63,39,5008,14.12587413
Archie Goodwin,203462,2013-14,20,7,7,0,8,44,10,16,28,1076,19.08646003
Alex Len,203458,2013-14,4,2,1,1,1,26,5,15,11,734,13.96449704
Miles Plumlee,203101,2013-14,43,18,18,0,10,111,25,64,47,3882,16.39046538
Dionte Christmas,202091,2013-14,8,3,3,0,4,6,1,3,3,398,16.84210526
Shavlik Randolph,101183,2013-14,1,0,0,0,0,5,1,3,2,182,11.32075472
Damian Lillard,203081,2013-14,457,157,110,47,145,193,100,58,135,5839,24.82564179
Dorell Wright,2748,2013-14,64,26,14,12,19,39,17,11,28,1945,16.27802691
Wesley Matthews,202083,2013-14,197,51,36,15,58,110,33,51,59,5501,19.58052903
CJ McCollum,203468,2013-14,27,10,7,3,6,35,10,16,19,939,20.79927339
Will Barton,203115,2013-14,33,11,8,3,15,18,4,9,9,768,21.42857143
Meyers Leonard,203086,2013-14,18,7,6,1,4,15,4,8,7,718,14.07588739
LaMarcus Aldridge,200746,2013-14,178,90,57,33,60,123,23,70,53,4926,29.96839888
Earl Watson,2248,2013-14,28,6,3,3,9,17,12,4,13,317,8.219178082
Victor Claver,201964,2013-14,12,3,2,1,9,11,3,6,5,359,14.5
Joel Freeland,200777,2013-14,36,22,17,5,7,32,7,16,16,1416,12.37298267
Allen Crabbe,203459,2013-14,6,3,1,2,1,3,1,0,3,206,15.54621849
Mo Williams,2590,2013-14,321,95,62,33,110,149,68,54,95,3627,20.40816327
Thomas Robinson,203080,2013-14,34,12,8,4,12,57,14,31,26,1699,19.79949875
Robin Lopez,201577,2013-14,73,30,23,7,23,84,18,42,42,5117,14.14107324
Nicolas Batum,201587,2013-14,420,106,75,31,170,208,105,79,129,5863,16.47492625
Ray McCallum,203492,2013-14,120,26,20,6,40,39,16,16,23,1729,17.83216783
Quincy Acy,203112,2013-14,28,8,6,2,10,30,7,17,13,1652,10.17745303
Rudy Gay,200752,2013-14,209,51,38,13,93,224,64,85,139,4948,27.52053119
Jared Cunningham,203099,2013-14,8,3,2,1,1,2,0,2,0,159,17.03296703
Derrick Williams,202682,2013-14,56,16,9,7,29,76,10,43,33,3596,16.21556307
DeMarcus Cousins,202326,2013-14,207,62,47,15,98,252,56,137,115,4519,32.73007316
Ben McLemore,203463,2013-14,82,16,10,6,38,96,27,41,55,4312,16.86844229
Isaiah Thomas,202738,2013-14,454,104,74,30,174,213,76,81,132,4962,25.74067619
Carl Landry,201171,2013-14,5,1,1,0,2,9,2,5,4,465,14.17769376
Travis Outlaw,2566,2013-14,48,12,5,7,23,26,9,12,14,2093,15.70179092
Reggie Evans,2501,2013-14,21,8,5,3,7,58,9,41,17,1724,13.47588265
Jason Terry,1891,2013-14,56,16,12,4,20,27,15,9,18,1098,14.70823341
Aaron Gray,201189,2013-14,22,4,4,0,14,31,7,23,8,693,12.6394052
Jason Thompson,201574,2013-14,53,15,12,3,21,95,15,57,38,3901,14.60923623
Kawhi Leonard,202695,2013-14,133,51,34,17,49,80,16,44,36,3803,18.30819981
Marco Belinelli,201158,2013-14,179,61,34,27,69,95,40,40,55,3969,19.03035795
Danny Green,201980,2013-14,104,17,13,4,48,76,32,30,46,3275,16.45810664
Cory Joseph,202709,2013-14,114,34,29,5,28,43,15,21,22,1844,17.22113503
Damion James,202345,2013-14,3,0,0,0,1,1,1,0,1,100,9.649122807
Patty Mills,201988,2013-14,149,56,39,17,55,63,31,19,44,3027,22.39858907
Tony Parker,2225,2013-14,388,121,83,38,139,151,42,80,71,3942,26.63636364
Jeff Ayres,201965,2013-14,60,21,13,8,18,63,22,33,30,1893,12.31203008
Matt Bonner,2588,2013-14,31,15,11,4,7,16,5,10,6,1366,12.13307241
Aron Baynes,203382,2013-14,34,9,6,3,10,36,11,18,18,977,18.84057971
Manu Ginobili,1938,2013-14,293,81,45,36,139,139,75,52,87,3122,24.39446367
Tim Duncan,1495,2013-14,220,45,35,10,112,159,51,67,92,4239,25.49143944
Tiago Splitter,201168,2013-14,90,23,15,8,49,75,23,36,39,2521,17.55994358
Austin Daye,201948,2013-14,8,1,1,0,5,5,4,1,4,300,22.74052478
Boris Diaw,2564,2013-14,222,65,30,35,93,121,39,58,63,3892,17.11378353
Landry Fields,202361,2013-14,20,7,4,3,9,11,4,5,6,616,12.21910112
Nando De Colo,201986,2013-14,65,22,13,9,24,35,15,12,23,964,18.4950136
Kyle Lowry,200768,2013-14,586,147,86,61,216,195,89,73,122,5553,22.63174404
DeMar DeRozan,201942,2013-14,313,160,111,49,82,176,44,67,109,5704,28.26020719
Dwight Buycks,202779,2013-14,10,5,4,1,3,10,4,3,7,278,18.42900302
Amir Johnson,101161,2013-14,115,29,23,6,43,123,32,69,54,4206,16.52480797
Steve Novak,200779,2013-14,13,6,4,2,6,5,0,4,1,1071,12.38793806
Jonas Valanciunas,202685,2013-14,57,17,12,5,21,136,15,84,52,4348,18.63792061
Greivis Vasquez,202349,2013-14,323,90,61,29,124,128,65,43,85,3353,21.64412071
John Salmons,2422,2013-14,147,55,38,17,40,54,25,20,34,3298,12.96101159
Terrence Ross,203082,2013-14,79,16,12,4,40,88,32,38,50,4158,18.64048976
Chuck Hayes,101236,2013-14,35,13,10,3,13,33,10,15,18,1435,10.40669856
Tyler Hansbrough,201946,2013-14,17,10,7,3,3,47,6,30,17,1870,14.85374771
Patrick Patterson,202335,2013-14,78,37,25,12,23,65,16,42,23,2934,17.40806643
Julyan Stone,202933,2013-14,12,6,3,3,4,5,1,3,2,226,8.914728682
Enes Kanter,202683,2013-14,75,31,27,4,19,144,23,84,60,4026,23.44456405
Marvin Williams,101107,2013-14,78,29,16,13,29,53,16,26,27,3171,17.0533967
Trey Burke,203504,2013-14,396,100,64,36,155,131,67,42,89,4313,21.90827191
John Lucas III,101249,2013-14,42,11,9,2,20,22,6,14,8,1144,16.25468165
Diante Garrett,203197,2013-14,120,37,22,15,42,75,37,31,44,1960,15.36412078
Alec Burks,202692,2013-14,212,57,44,13,78,149,49,66,83,4178,23.71369295
Derrick Favors,202324,2013-14,91,35,26,9,31,129,35,66,63,4179,21.02704987
Gordon Hayward,202330,2013-14,400,132,90,42,159,212,81,97,115,5339,23.11359527
Ian Clark,203546,2013-14,15,2,1,1,10,14,8,6,8,335,21.3740458
Malcolm Thomas,202952,2013-14,2,1,1,0,0,9,0,5,4,129,18.18181818
Richard Jefferson,2210,2013-14,130,34,27,7,63,93,36,39,54,4185,17.32116323
Brandon Rush,201575,2013-14,24,8,3,5,7,20,10,8,12,795,12.01298701
Rudy Gobert,203497,2013-14,7,1,1,0,4,32,6,18,14,838,13.87755102
Erik Murphy,203513,2013-14,2,0,0,0,1,2,0,0,2,124,10.56338028
Jeremy Evans,202379,2013-14,44,12,8,4,15,40,15,17,23,2270,15.45245399
Trevor Ariza,2772,2013-14,191,50,33,17,85,132,48,58,74,5387,17.58802238
John Wall,202322,2013-14,721,247,135,112,298,295,131,108,187,5876,27.07831325
Bradley Beal,203078,2013-14,243,58,39,19,78,128,52,50,78,4874,24.49385394
Marcin Gortat,101162,2013-14,138,41,31,10,33,126,28,65,61,5199,18.12457454
Al Harrington,1733,2013-14,28,8,6,2,13,34,7,23,11,986,23.02158273
Martell Webster,101110,2013-14,97,24,16,8,46,58,19,29,29,4169,14.76524325
Kevin Seraphin,202338,2013-14,17,8,7,1,5,41,6,22,19,1091,21.71837709
Glen Rice,203318,2013-14,7,0,0,0,5,9,4,3,6,216,19.06614786
Garrett Temple,202066,2013-14,72,29,20,9,21,42,22,14,28,1213,14.3982808
Otto Porter Jr.,203490,2013-14,10,3,3,0,2,14,7,5,9,613,15.1810585
Andre Miller,1889,2013-14,197,55,40,15,94,61,34,16,45,1853,15.30516432
Chris Singleton,202698,2013-14,6,0,0,0,6,17,1,13,4,479,17.26618705
Trevor Booker,202344,2013-14,64,29,22,7,24,58,17,27,31,2978,14.45289643
Nene ,2403,2013-14,153,35,24,11,67,117,25,67,50,3064,24.13592797
Drew Gooden,2400,2013-14,15,3,2,1,10,18,2,12,6,741,20.61978546